LK0001 我国现行法律体系中专门针对无线电管理的最高法律文件及其立法机关是：<br>中华人民共和国电信条例，国务院<br>中华人民共和国业余无线电台管理办法，工业和信息化部<br>中华人民共和国无线电管理条例，国务院和中央军委<br>中华人民共和国无线电管理办法，工业和信息化部	中华人民共和国无线电管理条例，国务院和中央军委
LK0002 我国现行法律体系中专门针对业余无线电台管理的最高法律文件及其立法机关是：<br>业余无线电台管理暂行规定，国家体委和国家无委<br>业余无线电台管理办法，工业和信息化部<br>中华人民共和国电信条例，国务院<br>个人业余无线电台管理暂行办法，国家体委和国家无委	业余无线电台管理办法，工业和信息化部
LK0003 我国的无线电主管部门是：<br>各级体育管理机构<br>各地业余无线电协会<br>各级无线电管理机构<br>各地电信管理局	各级无线电管理机构
LK0004 我国依法负责对业余无线电台实施监督管理的机构是：<br>在国家或地方民政部门注册的业余无线电协会<br>国家和地方公安部门<br>国家体育管理机构和地方体育管理机构<br>国家无线电管理机构和地方无线电管理机构	国家无线电管理机构和地方无线电管理机构
LK0005 《业余无线电台管理办法》所说的“地方无线电管理机构”指的是：<br>各地方与无线电设备生产销售和无线电应用有关的行政管理机构<br>地市县（区）及以下各级无线电管理机构<br>省、自治区、直辖市无线电管理机构<br>地方业余无线电协会或者类似组织机构	省、自治区、直辖市无线电管理机构
LK0011 国家鼓励和支持业余无线电台开展下列活动：<br>无线电通信技术研究、普及活动以及突发重大自然灾害等紧急情况下的应急通信活动<br>机动车辆行车服务性通信活动<br>作为日常公益活动的通信工具<br>休闲娱乐性交谈	无线电通信技术研究、普及活动以及突发重大自然灾害等紧急情况下的应急通信活动
LK0012 关于业余电台管理的正确说法是：<br>通过法律手段限制业余无线电台的设置<br>业余无线电爱好者的一切行为都受国家法律保护<br>依法设置的业余无线电台受国家法律保护<br>在业余电台与其他业务电台遇到干扰纠纷时无条件优先保护其他业务电台	依法设置的业余无线电台受国家法律保护
LK0104 无线电频率的使用必须得到各级无线电管理机构的批准，基本依据是“无线电频谱资源属于国家所有”，出自于下列法律的第二百五十二条： <br>中华人民共和国刑法<br>中华人民共和国民法典<br>中华人民共和国电信法<br>中华人民共和国宪法	中华人民共和国民法典
LK0007 我国对无线电管理术语“业余业务”、“卫星业余业务”和“业余无线电台”做出具体定义的法规文件是 <br>中华人民共和国电信条例<br>中华人民共和国无线电频率划分规定<br>无线电台执照管理规定<br>中华人民共和国无线电管理条例	中华人民共和国无线电频率划分规定
LK0008 业余电台的法定用途为：<br>供公民在业余时间进行休闲娱乐<br>供业余无线电爱好者进行自我训练、相互通信和技术研究<br>供私家车主或者相应组织作为行车安全保障和途中消遣工具<br>供公民在业余时间进行与个人生活事务有关的通信	供业余无线电爱好者进行自我训练、相互通信和技术研究
LK0111 无线电业余业务是供业余无线电爱好者作下列用途的无线电通信业务：<br>自我训练、相互通信和技术研究<br>救灾抢险、车队联络和技术学习<br>娱乐休闲、报告路况和公益服务<br>技术教学、民兵训练和公益通信	自我训练、相互通信和技术研究
LK0009 业余无线电台供下列人群设置和使用：<br>业余无线电爱好者，即任何对无线电技术有兴趣的人<br>业余无线电爱好者，即经正式批准的、对无线电技术有兴趣的人，其兴趣纯系个人爱好而不涉及谋取利润<br>对用无线电台解决日常通信有实际需求的任何公民、社团和单位<br>对无线电技术不感兴趣，但希望把业余无线电台用于业余消遣的公民	业余无线电爱好者，即经正式批准的、对无线电技术有兴趣的人，其兴趣纯系个人爱好而不涉及谋取利润
LK0051 “我不是业余无线电爱好者，申请设置业余电台只是为了行车方便，不需要遵守业余无线电的规范”。这种说法：<br>有一定道理，既然行车通信有需求，法规管理应该迎合个人需求<br>很难说对错，业余电台的定义可以因人而异<br>是错误的，也是不具备“熟悉无线电管理规定”设台条件的表现<br>有一定道理，只要是遵守规定，业余电台也可以为非业余无线电爱好者所用	是错误的，也是不具备“熟悉无线电管理规定”设台条件的表现
LK0052 个人提出设置使用业余无线电台申请，就是表示自己对无线电技术发生了兴趣，确认了自己在有关业余无线电台活动中的身份是：<br>汽车俱乐部会员，但不是业余无线电爱好者<br>其他职业人员，但不是业余无线电爱好者<br>业余无线电爱好者，但可以是正在起步的初学者<br>旅游爱好者，但不是业余无线电爱好者	业余无线电爱好者，但可以是正在起步的初学者
LK0112 符合业余无线电爱好者基本条件的人群是：<br>对无线电技术有兴趣并加入业余无线电协会的人<br>任何对无线电技术有兴趣的公民<br>对无线电技术有兴趣并经无线电管理机构批准设置使用业余无线电台的人<br>拥有较高无线电技术水平并加入业余无线电协会的人	对无线电技术有兴趣并经无线电管理机构批准设置使用业余无线电台的人
LK0013 不同类别业余无线电台的主要区别在于：<br>允许发射的频率范围和最大发射功率<br>所用业余无线电台的天线的高度和长度<br>设置和操作人员的业余无线电知识和技术水平<br>所用业余无线电台设备的功能和价格	允许发射的频率范围和最大发射功率
LK0014 A类业余无线电台允许发射的发射频率为：<br>各业余业务和卫星业余业务频段<br>30-3000MHz范围内的各业余业务和卫星业余业务频段<br>各VHF和UHF频段<br>所有VHF和UHF频段	30-3000MHz范围内的各业余业务和卫星业余业务频段
LK0017 A类业余无线电台允许发射的最大发射功率为不大于：<br>30MHz以上业余频段不大于100瓦，30MHz以下业余频段不大于25瓦<br>25瓦<br>100瓦<br>30MHz以下业余频段不大于100瓦，30MHz以上业余频段不大于25瓦	25瓦
LK0026 个人申请设置具有发信功能的业余无线电台的年龄条件是：<br>具备《业余无线电台操作证书》者申请设置业余无线电台不受年龄限制<br>年满十八周岁<br>年满十四周岁<br>年满十六周岁	年满十八周岁
LK0027 独立操作具有发信功能业余无线电台的年龄条件是：<br>年满十四周岁<br>具备《业余无线电台操作证书》者操作业余无线电台不受年龄限制<br>年满十六周岁<br>年满十八周岁	具备《业余无线电台操作证书》者操作业余无线电台不受年龄限制
LK0041 申请设置业余无线电台应当具备的条件有：<br>熟悉无线电管理规定、具备国家规定的操作技术能力、发射设备符合国家技术标准、当地无线电管理机构委托的受理机构设置的其他条件<br>加入指定协会、具备当地无线电管理机构规定的操作技术能力、发射设备符合国家技术标准、法律和行政法规规定的其他条件<br>熟悉无线电管理规定、具备国家规定的操作技术能力、发射设备符合国家技术标准、法律和行政法规规定的其他条件<br>熟悉无线电管理规定、具备当地无线电管理机构委托的考试机构设置的操作技术能力标准、发射设备符合国家技术标准、法律和行政法规规定的其他条件	熟悉无线电管理规定、具备国家规定的操作技术能力、发射设备符合国家技术标准、法律和行政法规规定的其他条件
LK0042 使用业余无线电台应当具备的条件有：<br>具备国家或地方无线电管理机构核发的业余无线电台执照<br>使用具有发信功能的业余无线电台的，应当年满十八周岁<br>熟悉无线电管理规定、具备国家规定的操作技术能力并取得相应操作技术能力证明<br>熟悉无线电管理规定、实际上具备国家规定的操作技术能力但不必需取得相应的证明	熟悉无线电管理规定、具备国家规定的操作技术能力并取得相应操作技术能力证明
LK0020 负责组织A类和B类业余无线电台所需操作技术能力的验证的机构是：<br>地方教育、体育机构及其相关民间组织<br>地方业余无线电协会<br>地方无线电管理机构（或其委托单位）<br>国家无线电管理机构和地方无线电管理机构（或其委托单位）	国家无线电管理机构和地方无线电管理机构（或其委托单位）
LK0022 2013年1月1日以后新获得的各类业余无线电台操作技术能力证明文件是：<br>中国无线电协会颁发的“业余无线电台操作证书”<br>地方无线电协会或者其他业余无线电民间组织出具的盖有公章的证明信件<br>地方无线电协会或者其他业余无线电民间组织颁发的“业余无线电台操作证书”<br>中国无线电运动协会颁发的“业余无线电台操作证书”	中国无线电协会颁发的“业余无线电台操作证书”
LK0043 申请设置和使用业余无线电台的条件所规定的“具备国家规定的操作技术能力”，其标志为：<br>业余无线电爱好者公认具备国家规定的操作技术能力的人，可以免交相应的操作技术能力证明<br>取得相应操作技术能力证明，即中国无线电协会颁发的业余无线电台操作证书<br>境外无线电管理机构颁发或者开具的业余无线电台执照或证书也可以作为具备国家规定的操作技术能力的证明<br>取得相应操作技术能力证明，即地方业余无线电协会所颁发的业余无线电台操作证书	取得相应操作技术能力证明，即中国无线电协会颁发的业余无线电台操作证书
LK0006 合法设置业余电台的必要步骤是：<br>按《业余无线电台管理办法》的规定办理设置审批手续，并取得业余电台执照<br>经过所在单位或居委会批准<br>经过业余无线电协会或无线电运动协会同意<br>加入指定的业余无线电民间组织,并按其章程规定的办法办理申请手续	按《业余无线电台管理办法》的规定办理设置审批手续，并取得业余电台执照
LK0010 按照《业余电台管理办法》规定，申请设置使用配备有多台业余无线电发射设备的业余无线电台，应该：<br>视为一个业余电台，指配一个电台呼号，但所有设备均应经过核定并将参数载入电台执照<br>视为一个业余电台，指配一个电台呼号，其中只需有一台设备加以核定并将参数载入电台执照<br>视为一个业余电台，指配一个电台呼号，每个频段选择一台设备加以核定并将参数载入电台执照<br>每台设备视为一个业余电台，各指配一个电台呼号，并都应经过核定并将参数载入电台执照	视为一个业余电台，指配一个电台呼号，但所有设备均应经过核定并将参数载入电台执照
LK0023 个人申请设置业余无线电台应当提交的书面材料为：<br>两种表格，身份证和操作证书的原件、复印件<br>一种表格，身份证和操作证书的原件、复印件<br>三种表格，身份证的原件、复印件<br>本人写的申请书，身份证和操作证书的原件、复印件	两种表格，身份证和操作证书的原件、复印件
LK0028 申请设置下列业余无线电台时应在《业余无线电台设置（变更）申请表》 的“台站种类”选择“特殊”类：<br>需要到外地移动操作的手持台<br>移动操作的车载台<br>中继台、信标台、空间台<br>用于业余卫星通信的地面业余无线电台	中继台、信标台、空间台
LK0029 申请设置信标台、空间台和技术参数需要超出管理办法规定的特殊业余电台的办法为：<br>按照设置一般业余电台的办法申请即可，然后根据需要操作就可以<br>在《业余无线电台设置（变更）申请表》 的“台站种类”选择“特殊”类，由地方无线电管理机构受理和初审后交国家无线电管理机构审批<br>必须由地方业余无线电协会作为申请单位，经本地无线电管理机构办理批准设台<br>先按设置一般业余电台的办法申请，然后再到本地无线电管理机构办理变更执照核定内容	在《业余无线电台设置（变更）申请表》 的“台站种类”选择“特殊”类，由地方无线电管理机构受理和初审后交国家无线电管理机构审批
LK0030 负责受理设置业余无线电台申请的机构为：<br>中国无线电协会<br>任何地方业余无线电民间组织<br>设台地地方无线电管理机构或其正式委托的代理受理服务机构<br>国家无线电管理机构	设台地地方无线电管理机构或其正式委托的代理受理服务机构
LK0031 设置在省、自治区、直辖市范围内通信的业余无线电台，审批机构为：<br>设台地的地方无线电管理机构所委托的其他单位<br>设台地的地方无线电民间机构<br>国家无线电管理机构<br>设台地的地方无线电管理机构	设台地的地方无线电管理机构
LK0032 设置通信范围涉及两个以上的省、自治区、直辖市或者涉及境外的一般业余无线电台，审批机构是下列中：<br>国家无线电管理机构委托的设台地地方无线电民间组织<br>设台地地方无线电管理机构<br>设台地的地方无线电民间组织<br>国家无线电管理机构或其委托的设台地的地方无线电管理机构	国家无线电管理机构或其委托的设台地的地方无线电管理机构
LK0033 按照在省、自治区、直辖市范围内通信所申请设置的业余无线电台，如想要将通信范围扩大至涉及两个以上的省、自治区、直辖市或者涉及境外，或者要到设台地以外进行异地发射操作，须办理下列手续：<br>反正已经有了电台执照，可先扩大操作起来，等执照有效期届满时再申请办理变更手续，换发业余无线电台执照<br>只要不会被发现，可以不申请办理变更手续，悄悄越限操作<br>反正已经有了电台执照，只需向核发执照的无线电管理机构通报变更情况即可，不必申请办理变更和换发执照<br>事先向核发执照的无线电管理机构申请办理变更手续，按相关流程经国家无线电管理机构或其委托的设台地的地方无线电管理机构批准后，换发业余无线电台执照	事先向核发执照的无线电管理机构申请办理变更手续，按相关流程经国家无线电管理机构或其委托的设台地的地方无线电管理机构批准后，换发业余无线电台执照
LK0044 业余无线电台执照有效期届满后需要继续使用的，应当在下列期限内向核发执照的无线电管理机构申请办理延续手续：<br>有效期届满一个月前<br>有效期届满一个月之内<br>有效期届满三个月之内<br>有效期届满二十天前	有效期届满一个月前
LK0045 因改进或调整业余发射设备使业余无线电台的技术参数超出其业余无线电台执照所核定的范围时，应当办理下列手续：<br>只要设备型号和产品序列号没有改变，不必申请办理变更手续<br>等执照有效期届满时向核发执照的无线电管理机构申请办理变更手续，换发业余无线电台执照<br>及时向核发执照的无线电管理机构申请办理变更手续，换发业余无线电台执照<br>只需及时向核发执照的无线电管理机构通报变更情况，进行备案即可	及时向核发执照的无线电管理机构申请办理变更手续，换发业余无线电台执照
LK0046 终止使用业余无线电台的，应当向下列机构申请注销执照：<br>国家无线电管理机构<br>核发业余无线电台执照的无线电管理机构<br>受国家无线电管理机构委托的地方业余无线电民间组织<br>受国家无线电管理机构委托的全国性业余无线电民间组织	核发业余无线电台执照的无线电管理机构
LK0089 经地方无线电管理机构批准设置的业余无线电台，设台地迁入其他省、自治区或者直辖市时，应办理的手续为：<br>先到原核发执照的无线电管理机构办理申请注销原业余无线电台，再到迁入地的地方无线电管理机构办理申请设置业余无线电台的手续<br>不需要办理任何手续<br>持原电台执照直接到迁入地的地方无线电管理机构申请办理变更手续<br>持原电台执照直接到原核发执照的无线电管理机构申请办理变更手续	先到原核发执照的无线电管理机构办理申请注销原业余无线电台，再到迁入地的地方无线电管理机构办理申请设置业余无线电台的手续
LK0090 经国家无线电管理机构批准设置的业余无线电台，设台地迁入其他省、自治区或者直辖市时，应办理的手续为：<br>先到原核发执照的无线电管理机构申请办理注销手续，缴回原电台执照，领取国家无线电管理机构已批准设台的证明，凭证明到迁入地的地方无线电管理机构完成申请变更手续，领取新电台执照<br>不需要办理任何手续<br>持原电台执照直接到原核发执照的无线电管理机构申请办理变更手续<br>持原电台执照直接到迁入地的地方无线电管理机构申请办理变更手续	先到原核发执照的无线电管理机构申请办理注销手续，缴回原电台执照，领取国家无线电管理机构已批准设台的证明，凭证明到迁入地的地方无线电管理机构完成申请变更手续，领取新电台执照
LK0024 业余无线电台专用无线电发射设备的重要特征是：<br>发射频率必须覆盖所有业余频段<br>必须具有数字对讲方式<br>发射频率不得超出业余频段<br>发射方式必须包含调频	发射频率不得超出业余频段
LK0025 业余无线电发射设备的下列指标必须符合国家的相关规定：<br>指配频带和必要带宽<br>频率容限和杂散域发射功率<br>频率容限和带外发射<br>频率调制频偏和调制度	频率容限和杂散域发射功率
LK0038 业余无线电台使用的发射设备必须符合下列条件：<br>必须具备《无线电发射设备型号核准证》<br>商品设备应当具备《无线电发射设备型号核准证》，自制、改装、拼装设备应通过国家相关技术标准的检测<br>商品设备应当具备《无线电发射设备型号核准证》，自制、改装、拼装设备不受限制<br>国产商品设备应当具备《无线电发射设备型号核准证》，国外商品设备符合国际流行技术标准即可	商品设备应当具备《无线电发射设备型号核准证》，自制、改装、拼装设备应通过国家相关技术标准的检测
LK0039 对业余无线电台专用无线电发射设备进行型号核准的依据为：<br>国家关于专业无线电通信发射设备的技术标准<br>地方无线电管理机构制订的技术标准<br>国家《无线电频率划分规定》中有关无线电发射设备技术指标的规定<br>经国家认证的检测单位所制订的技术标准	国家《无线电频率划分规定》中有关无线电发射设备技术指标的规定
LK0040 业余无线电台专用无线电发射设备的发射频率必须满足的条件是：<br>发射频率不能超越业余业务或者卫星业余业务频段<br>发射频率可以在业余频段和非业余频段之间选择<br>发射频率包含所有业余业务或者卫星业余业务频段<br>发射频率包含至少一个业余业务或者卫星业余业务频段	发射频率不能超越业余业务或者卫星业余业务频段
LK0116 业余电台的无线电发射设备应符国家规定的下列主要技术指标：<br>杂散发射不低于最大允许功率电平、电源电压及频率符合国家电网标准、采用标准天线阻抗<br>符合频率容限、符合杂散发射最大允许功率电平<br>杂散发射不低于最大允许功率电平、频率漂移不低于频率容限、电源利用效率满足节能要求<br>工作频率范围足够宽、杂散发射不低于最大允许功率电平、带宽大于允许最低值	符合频率容限、符合杂散发射最大允许功率电平
LK0117 频率容限是发射设备的重要指标，通常用下述单位来表示：<br>百万分之几（或者赫兹）<br>dB<br>瓦<br>百分之几（或者兆赫）	百万分之几（或者赫兹）
LK0118 杂散域发射功率是发射设备的重要指标，通常用下述单位来表示：<br>百分之几<br>千赫（或者赫芝）<br>绝对功率（瓦）<br>绝对功率dBm、低于载波发射功率的分贝值dBc、低于PEP发射功率的相对值dB	绝对功率dBm、低于载波发射功率的分贝值dBc、低于PEP发射功率的相对值dB
LK0125 辐射（radiation）是指任何源的能量流以无线电波的形式向外发出。正确的说法是：<br>闪电产生的电磁波干扰是一种辐射<br>射频电路中电容器内极板间的电场是一种辐射<br>射频电路中变压器内磁芯里的磁场是一种辐射<br>沿电源线窜入接收机的差模干扰是一种辐射	闪电产生的电磁波干扰是一种辐射
LK0126 发射（emission）是指：由无线电发信电台产生的辐射或辐射产物。正确的说法是：<br>医用高频电疗机向周围发送的无线电波能量是一种发射<br>业余电台向周围发送的杂散产物是一种发射<br>无线电接收机本地振荡器辐射的能量是一种发射<br>闪电产生的电磁波干扰是一种发射	业余电台向周围发送的杂散产物是一种发射
LK0137 杂散发射是指必要带宽之外的一个或多个频率的发射，其发射电平可降低而不致影响相应信息的传输。一台发射机，工作频率为145.000MHz，但在435.000MHz的频率上也有发射。这种发射属于：<br>带外发射<br>带内发射<br>谐波发射<br>杂散发射	杂散发射
LK0139 业余无线电专用发射设备必须满足的主要技术指标要求包括：<br>频率容限不低于限值，杂散辐射不超过限值，发射频率不超出国家规定的业余频率<br>频率容限和杂散辐射不超过限值，发射频率包括国家规定的业余频率<br>频率容限和杂散辐射不超过限值，发射频率不超出国家规定的业余频率<br>发射功率不低于功率限额，输出阻抗符合工业标准	频率容限和杂散辐射不超过限值，发射频率不超出国家规定的业余频率
LK0047 业余无线电台使用的频率应当符合下述规定：<br>《中华人民共和国无线电频率划分规定》<br>ITU《无线电规则》第IV节“频率划分表”<br>IARU三区“频率规划”<br>一般业余无线电书籍所叙述的频率	《中华人民共和国无线电频率划分规定》
LK0048 业余无线电台在业余业务、卫星业余业务作为次要业务使用的频率或者与其他主要业务共同使用的频率上发射操作时，应当注意：<br>首先守听频率是否已由其他业务电台占用，如听不到，即可按照先来先用的原则放心使用<br>只要遵守了《中华人民共和国无线电频率划分规定》的有关规定即可放心使用<br>可以任意使用，但在遇到其他业务电台使用时要主动避让<br>遵守无线电管理机构对该频率的使用规定	遵守无线电管理机构对该频率的使用规定
LK0049 关于业余频率的使用，正确的叙述是：<br>任何业余无线电台在任何频段都享有平等的频率使用权<br>业余无线电台在无线电管理机构核准其使用的频段内，享有平等的频率使用权<br>依法成立的地方业余无线电民间组织的业余电台，在其常用的台网频率上享有比其他个人设置的业余电台优先的使用权<br>业余无线电台在无线电管理机构核准其使用的频段内，不同类别的业余电台享有不同优先程度的频率使用权	业余无线电台在无线电管理机构核准其使用的频段内，享有平等的频率使用权
LK0113 在无线电管理中，由国家将某个特定的频带列入频率划分表，规定该频带可在指定的条件下供业余业余业务或者卫星业余业务使用，这个过程称为：<br>分配<br>划分<br>指配<br>授权	划分
LK0114 在无线电管理中，将无线电频率或频道规定由一个或多个部门，在指定的区域内供地面或空间无线电通信业务在指定条件下使用，这个过程称为：<br>授权<br>指配<br>划分<br>分配	分配
LK0115 在无线电管理中，将无线电频率或频道批准给具体的业余无线电台在规定条件下使用，这个过程称为：<br>指配<br>分配<br>授权<br>划分	指配
LK0140 在频率划分表中，一个频带被标明划分给多种业务时，这些业务被分为下述类别：<br>业余业务和非业余业务<br>主要业务和次要业务<br>安全业务和一般业务<br>民用业务和军用业务	主要业务和次要业务
LK0141 在频率划分表中，当一个频段划分给业余业务或卫星业余业务和多个其他业务，并且业余业务和卫星业余业务作为次要业务时，业余无线电台应该遵循的规则是：<br>容许因设备技术问题对主要业务电台产生短时间有害干扰<br>不得对主要业务电台产生有害干扰<br>不得对来自同一业务或其他次要业务电台的有害干扰提出保护要求<br>可要求保护不受来自主要业务电台的有害干扰	不得对主要业务电台产生有害干扰
LK0142 在频率划分表中，当一个频段划分给业余业务或卫星业余业务和多个其他业务，并且业余业务和卫星业余业务作为次要业务时，业余无线电台遵循的规则是：<br>可要求保护不受来自主要业务电台的有害干扰<br>不得对来自同一业务或其他次要业务电台的有害干扰提出保护要求<br>不得对来自主要业务电台的有害干扰提出保护要求<br>容许因设备技术问题对主要业务电台产生短时间有害干扰	不得对来自主要业务电台的有害干扰提出保护要求
LK0143 在频率划分表中，当一个频段划分给业余业务或卫星业余业务和多个其他业务，并且业余业务和卫星业余业务作为次要业务时，业余无线电台遵循的规则是：<br>不得对来自同一业务或其他次要业务电台的有害干扰提出保护要求<br>可要求保护不受来自主要业务电台的有害干扰<br>可要求保护不受来自同一业务或其他次要业务电台的有害干扰<br>容许因设备技术问题对主要业务电台产生短时间有害干扰	可要求保护不受来自同一业务或其他次要业务电台的有害干扰
LK1112 VHF段的频率范围是多少？<br>30到300MHz<br>300到3000MHz<br>30到300kHz<br>300到3000kHz	30到300MHz
LK1113 UHF段的频率范围是多少？<br>300到3000MHz<br>300到3000kHz<br>30到300kHz<br>30到300MHz	300到3000MHz
LK1114 HF段的频率范围是多少？<br>300到3,000kHz<br>300到3,000MHz<br>30到300MHz<br>3到30MHz	3到30MHz
LK0144 我国分配给业余业务和卫星业余业务专用的频段有：<br>3.5MHz、14MHz、21MHz、28MHz、10GHz频段<br>7MHz、14MHz、21MHz、28MHz、144MHz频段<br>7MHz、14MHz、28MHz、144MHz、430MHz频段<br>7MHz、14MHz、21MHz、28MHz、47GHz频段	7MHz、14MHz、21MHz、28MHz、47GHz频段
LK0146 [Q]我国在VHF和UHF范围内分配给业余业务和卫星业余业务与其他业务共用并设业务类别为主要业务与次要业务，以下那些频率分配给业余业务和卫星业余业务与其他业务共用并且业余业务和卫星业余业务作为主要业务： <br>144MHz、430MHz<br>50MHz、144MHz<br>220MHz、430MHz<br>50MHz、430MHz	50MHz、144MHz
LK0147 我国分配给业余业务和卫星业余业务与其他业务共用、并且业余业务和卫星业余业务作为唯一主要业务的频段的个数以及在3GHz以下的该类频段分别为：<br>5个，50-54MHz<br>4个，7.0-7.2MHz<br>5个，28-29.7MHz<br>3个，144-146MHz	3个，144-146MHz
LK0148 我国分配给业余业务和卫星业余业务与其他业务共用、并且业余业务和卫星业余业务作为次要业务的1200MHz以下频段有：<br>3.5MHz、7MHz、50MHz<br>135.7kHz、10.1MHz、430MHz<br>3.5MHz、18.068MHz、144MHz<br>10.1MHz、24.89MHz、430MHz	135.7kHz、10.1MHz、430MHz
LK0157 俗称的6米业余波段的频率范围以及业余业务和卫星业余业务的使用状态分别为：<br>52-56MHz，次要业务<br>50-54MHz，主要业务<br>50-52MHz，次要业务<br>51-54MHz，专用	50-54MHz，主要业务
LK0158 俗称的2米业余波段的频率范围以及我国业余业务和卫星业余业务的使用状态分别为：<br>144-146MHz；专用<br>144-148MHz；其中144-146MHz为唯一主要业务，146-148MHz为与其他业务共同作为主要业务<br>144-148MHz；其中144-146MHz为专用，146-148MHz为次要业务<br>144-148MHz；次要业务	144-148MHz；其中144-146MHz为唯一主要业务，146-148MHz为与其他业务共同作为主要业务
LK0159 俗称的0.7米业余波段的频率范围以及业余业务和卫星业余业务的使用状态分别为：<br>430-440MHz，专用<br>420-470MHz，次要业务<br>430-440MHz，次要业务<br>430-440MHz，主要业务	430-440MHz，次要业务
LK0160 在我国和多数其他国家的频率分配中，业余业务在430-440MHz频段中作为次要业务与其他业务共用。这个频段中我国分配的主要业务是：<br>水上移动和航空移动<br>固定业务<br>移动业务<br>无线电定位和航空无线电导航	无线电定位和航空无线电导航
LK0171 VHF业余无线电台在144MHz频段进行本地联络时应避免占用的频率为：<br>144.050-144.053MHz和145.100-145.750MHz<br>144.035-144.053MHz和145.550-145.750MHz<br>144.035-145.8MHz<br>144-144.035MHz和145.8-146MHz	144-144.035MHz和145.8-146MHz
LK0172 UHF业余无线电台在430MHz频段进行本地联络时应避免占用的频率为：<br>431-432MHz和438-440MHz<br>430-431.2MHz和435-436MHz<br>431.9-432.240MHz和435-438MHz<br>430-431.9MHz和432.240-435MHz	431.9-432.240MHz和435-438MHz
LK1031 430MHz业余频段中留给业余卫星通信使用，话音及其他通信方式不应占用的频率段为：<br>438MHz至439MHz<br>432MHz至434MHz<br>433MHz至435MHz<br>435MHz至438MHz	435MHz至438MHz
LK1032 144MHz业余频段中留给业余卫星通信使用，话音及其他通信方式不应占用的频率段为：<br>145.8MHz至146MHz<br>144.8MHz至145MHz<br>145.4MHz至144.6MHz<br>144.2MHz至144.5MHz	145.8MHz至146MHz
LK0077 《业余无线电台管理办法》规定业余无线电台设置、正确使用业余无线电台呼号的办法规是：<br>业余电台在通信中可以用姓名、代号、适当的别名或者法规定呼号的部分数字和字母代替完整的业余电台呼号作为电台的标识<br>业余电台在和熟悉的通信对象联络、已经从信号特征确认双方业余电台身份时，可以省略呼号的发送<br>业余无线电台应当在每次通信建立及结束时，主动报出本台呼号，在发射过程中至少每十分钟报出本台呼号一次；对于通信对方，也应使用对方电台的呼号加以标识<br>业余电台在通信中可以用自造的呼号作为无线电管理机构指配的业余电台呼号的补充，一起作为电台的标识	业余无线电台应当在每次通信建立及结束时，主动报出本台呼号，在发射过程中至少每十分钟报出本台呼号一次；对于通信对方，也应使用对方电台的呼号加以标识
LK0078 业余无线电台应当在每次通信建立及结束时，主动报出本台呼号，在发射过程中至少每十分钟报出本台呼号一次。这里的“呼号”是指：<br>完整的电台呼号，如在设台地以外的地点进行异地发射操作，还应在前面加上字母B、操作地分区号和符号“/”<br>一般指无线电管理机构指配的电台呼号，但也可以是对方能够理解的民间自创呼号、代号、代码等<br>可以是完整的电台呼号，也可以是完整电台呼号的任何一部分<br>可以是完整的电台呼号，也可以是电台呼号的分区号加后缀	完整的电台呼号，如在设台地以外的地点进行异地发射操作，还应在前面加上字母B、操作地分区号和符号“/”
LK0080 业余无线电台呼号的指配流程是：<br>在向无线电管理机构委托的受理服务机构提交设台申请窗口后，由服务机构指配呼号<br>无线电管理机构核发业余无线电台执照时，同时指配业余无线电台呼号<br>业余无线电台设台人在提交设台申请的同时提出所要求指配的呼号，经服务机构同意后，报无线电管理机构正式指配<br>无线电管理机构核发业余无线电台执照后，由申请人再向其申请指配呼号	无线电管理机构核发业余无线电台执照时，同时指配业余无线电台呼号
LK0081 业余无线电爱好者对业已指配给自己的电台呼号不满意，是否可以申请另行指配业余无线电台呼号？<br>业余无线电台执照有效期届满、设台人向核发执照的无线电管理机构申请办理延续手续时可以申请另行指配业余无线电台呼号<br>更新所设置的业余无线电台类别时可以申请另行指配业余无线电台呼号<br>可以申请另行指配业余无线电台呼号，但须缴纳额外的费用<br>不可以。核发业余无线电台执照的无线电管理机构已经为申请人指配业余无线电台呼号的，不另行指配其他业余无线电台呼号	不可以。核发业余无线电台执照的无线电管理机构已经为申请人指配业余无线电台呼号的，不另行指配其他业余无线电台呼号
LK0082 各地业余无线电台呼号前缀字母和后缀字符的可用范围的确定方法是：<br>地方无线电民间组织提出建议，当地无线电管理机构批准<br>由国家无线电管理机构编制和分配<br>地方无线电管理机构根据当地呼号资源的使用情况自行分配<br>由业余无线电爱好者根据需求提出建议，当地无线电管理机构批准	由国家无线电管理机构编制和分配
LK0083 业余无线电爱好者是否可要求设台地所在地方无线电管理机构给予指配超出业已分配给该地方的前缀字母和后缀字符可用范围的业余无线电台呼号？<br>可以，但只限于与在当地所举办的大型国际或国家级活动有关的特殊电台<br>可以，但只限于当地业余无线电台参加国际重要业余无线电活动的特殊情况<br>不能，特殊业余无线电台呼号只能由国家无线电管理机构指配<br>可以，但只限于与当地政府组织的大型科技活动有关的特殊电台	不能，特殊业余无线电台呼号只能由国家无线电管理机构指配
LK0091 设台地迁入其他省、自治区或者直辖市时，业余电台呼号的指配方法为：<br>可以在保留原电台呼号的同时申请指配迁入地的新电台呼号<br>必须指配迁入地的新电台呼号<br>必须继续指配原来的电台呼号<br>由设台人选择：方法一，注销原电台呼号，指配迁入地的新电台呼号；方法二，申请在迁入地继续指配原来的电台呼号	由设台人选择：方法一，注销原电台呼号，指配迁入地的新电台呼号；方法二，申请在迁入地继续指配原来的电台呼号
LK0092 设台地迁入其他省、自治区或者直辖市时，申请在迁入地继续指配原来的电台呼号的手续为：<br>先到原核发执照的无线电管理机构申请办理注销手续，缴回原电台执照，取得由迁入地指配原业余无线电台呼号的书面同意，再到迁入地的地方无线电管理机构办理相应的手续、重新指配原电台呼号，领取新的电台执照<br>只需到原核发执照的无线电管理机构申请申请办理为迁移后的电台继续使用原电台呼号的全部手续<br>只需到迁入地的地方无线电管理机构申请申请办理为迁移后的电台继续使用原电台呼号的全部手续<br>不需办理任何手续即可把原电台呼号带到迁入地继续使用	先到原核发执照的无线电管理机构申请办理注销手续，缴回原电台执照，取得由迁入地指配原业余无线电台呼号的书面同意，再到迁入地的地方无线电管理机构办理相应的手续、重新指配原电台呼号，领取新的电台执照
LK1072 在实际通信中，是否可以把本台呼号的地区号码加后缀视作《业余电台管理办法》所说的“本台呼号”？<br>在VHF/UHF频段进行本地呼叫和联络时可以把不完整呼号视作“呼号”<br>在熟悉的友台之间呼叫和联络中可以把不完整呼号视作“呼号”<br>在HF频段进行国内呼叫和联络时可以把不完整呼号视作“呼号”<br>不可以。不完整呼号不具有呼号的属性，不能视作呼号	不可以。不完整呼号不具有呼号的属性，不能视作呼号
LK0079 由国家无线电管理机构批准设台的北京火腿的电台呼号为BH1AAA，把电台带到西安去使用，则本台呼号应该为：<br>B9/BH1AAA<br>BH1AAA/B9<br>BH1AAA/9<br>B1/BH9AAA	B9/BH1AAA
LK0084 某业余无线电爱好者，自己所设置的业余无线电台呼号为BH1ZZZ。现该爱好者到业余无线电台BH9YYY做客并在该台进行发射操作。应当使用的呼号为：<br>BH1ZZZ或者B9/BH1ZZZ<br>BH1ZZZ/9或者BH1ZZZ/BH9<br>BH9YYY或者B9/BH1ZZZ<br>BH9/BH1ZZZ或者BH1ZZZ	BH9YYY或者B9/BH1ZZZ
LK0086 某业余无线电爱好者，自己所设置的业余无线电台呼号为BH1ZZZ。现该爱好者将自己的业余无线电台带到湖南进行异地发射操作。应当使用的呼号为：<br>BH1ZZZ/B7<br>BH1ZZZ<br>B7/BH1ZZZ<br>BH7/BH1ZZZ	B7/BH1ZZZ
LK0087 某业余无线电爱好者，自己所设置的业余无线电台呼号为BH1ZZZ。现该爱好者到业余无线电台BH3YYY做客并并在该台进行发射操作。这种发射操作在业余无线电台管理中称为：<br>违章发射操作<br>移动发射操作<br>异地发射操作<br>客席发射操作	客席发射操作
LK0088 某业余无线电爱好者，自己所设置的业余无线电台呼号为BH1ZZZ。现该爱好者将自己的业余无线电台带到广东进行发射操作。这种发射操作在业余无线电台管理中称为：<br>临时发射操作<br>违章发射操作<br>客席发射操作<br>异地发射操作	异地发射操作
LK0093 BH1ZZZ由北京迁入河北省，并办妥了由河北无线电管理机构指配使用原电台呼号的全部手续，领取了新的业余无线电台执照。该台在日常通信时应使用呼号：<br>固定台址发射操作用BH1ZZZ，移动发射操用B3/BH1ZZZ<br>可任选使用呼号B3/BH1ZZZ或者BH1ZZZ<br>BH1ZZZ<br>B3/BH1ZZZ	B3/BH1ZZZ
LK0056 某业余电台操作者听到业余专用频率上出现某种显然出自非业余电台的人为干扰发射，于是按下话筒向该发射者宣传无线电管理法规知识。对这种做法的评论应该是：<br>错误；违反“业余无线电台的通信对象应当限于业余无线电台”规定。<br>正确；抓机遇宣传法规，应该提倡<br>正确；但有点条乱，不予提倡<br>正确；但需注意态度耐心、用语文明	错误；违反“业余无线电台的通信对象应当限于业余无线电台”规定。
LK0057 在业余无线电台中转发广播电台、互联网聊天、电话通话、其他电台的联络信号，这类行为的性质是：<br>错误行为；违反“业余无线电台的通信对象应当限于业余无线电台”规定，因为通信中产生信息的一方不是通信业余无线电台本身<br>正确行为；既然可以联络，不必要限制向话筒送什么内容<br>不算错误但也不值得提倡<br>如果转发的目的是进行技术调试、用转发信号作为测试信号的话，就是正常行为	错误行为；违反“业余无线电台的通信对象应当限于业余无线电台”规定，因为通信中产生信息的一方不是通信业余无线电台本身
LK0058 业余电台在通信中为其他人或者单位、组织转达信息。对这种做法的评论应该是：<br>违法行为；违反“业余无线电台的通信对象应当限于业余无线电台”的规定<br>只要所转达的信息在内容上不违反《业余电台管理办法规》的禁止规定就是合法行为<br>只要转达信息是无偿的，就是合法行为<br>只要所转达的信息是有利于社会的公益信息，就是合法行为	违法行为；违反“业余无线电台的通信对象应当限于业余无线电台”的规定
LK0059 某业余无线电协会在发射操作中向其会员播发公益性通知和技术训练讲座，但未得到相应无线电管理机构的批准。对这种做法的评论应该是：<br>只要所播发的通知或讲座有利于当地业余无线电爱好者技术水平的提高，不能算违法行为<br>违法行为；违反“未经核发业余无线电台执照的无线电管理机构批准，业余无线电台不得以任何方式进行广播或者发射通播性质的信号”的规定<br>只要所播发的通知或讲座有利于当地业余无线电应急通信训练，不能算违法行为<br>只要所播发的通知或讲座是涉及宣传业余电台管理知识的，不能算违法行为	违法行为；违反“未经核发业余无线电台执照的无线电管理机构批准，业余无线电台不得以任何方式进行广播或者发射通播性质的信号”的规定
LK0060 关于业余无线电台在通信过程中使用的语言，正确的做法为：<br>可提倡使用稀有语言或方言，尽量使特定通信对象以外的业余无线电台听不懂，以减少他台呼叫和插入的机会<br>任何时候都应当使用明语及业余无线电领域公认的缩略语和简语<br>语言要创新，可以使用自创的特殊缩略语，虽开始时象是暗语，用多了就会变明语<br>可以使用虽然不是所有火腿通用、但在某些火腿圈子内部有一定可懂度的新编缩略语或暗语	任何时候都应当使用明语及业余无线电领域公认的缩略语和简语
LK0061 业余无线电台实验新的编码、调制方式、数字通信协议或者交换尚未公开格式的数据文件，正确做法是：<br>事先尽可能采取各种办法向信号可能覆盖范围内的业余无线电爱好者公开有关技术细节，并提交给核发其业余无线电台执照的地方无线电管理机构<br>应事先提交给核发其业余无线电台执照的地方无线电管理机构，但不必向其他业余无线电爱好者公开有关技术细节<br>不必事先公开或者提交给核发其业余无线电台执照的地方无线电管理机构，以后再说<br>事先尽可能采取各种办法向信号可能覆盖范围内的业余无线电爱好者公开有关技术细节，但不必提交给核发其业余无线电台执照的地方无线电管理机构	事先尽可能采取各种办法向信号可能覆盖范围内的业余无线电爱好者公开有关技术细节，并提交给核发其业余无线电台执照的地方无线电管理机构
LK0062 由国家无线电管理机构审批的业余无线电台在设台地以外的地点进行异地发射操作时，应该注意：<br>遵守的限制以业余电台执照所核定的各项参数和核发其业余电台执照的地方无线电管理机构的规定为准，与操作所在地的规定无关<br>遵守的限制以操作所在地的地方无线电管理机构的相关规定为准，与核发电台执照的地方无线电管理机构的规定无关<br>既要符合业余电台执照所核定的各项参数约束，又要遵守操作所在地的地方无线电管理机构的相关规定<br>有了电台执照就是万事大吉，不必认真了解和遵守什么具体规定	既要符合业余电台执照所核定的各项参数约束，又要遵守操作所在地的地方无线电管理机构的相关规定
LK0063 具备国家无线电管理机构规定的操作技术能力并具有法律规定有效证明文件、但还没有获准设置自己的业余电台的人是否可以到业余电台进行发射操作？答案是：<br>可以。使用所操作业余电台的呼号，由该业余电台的设台人对操作不妥而造成的有害干负责<br>不可以<br>可以。因为自己没有呼号，只能在通信中使用临时自编的呼号，或用姓名代替呼号<br>青少年可以，成人不可以	可以。使用所操作业余电台的呼号，由该业余电台的设台人对操作不妥而造成的有害干负责
LK0064 尚未考得《业余电台操作证书》的人在接受业余电台培训中实习发射操作应遵守的条件是什么？<br>尚未取得关于具备操作技术能力有效证明文件的人任何情况下都不可以进行发射操作<br>只要业余电台设置人或者其技术负责人能确认实际上已经具备操作技术能力，可以独立进行发射操作，并能为其操作不善造成的后果负责，可以独立发射操作<br>尚未取得关于具备操作技术能力有效证明文件者如为青少年，可以在集体业余电台独立操作，如为成人则任何情况下都不可以进行发射操作<br>必须已接受法规等基础培训、必须由电台负责人现场辅导、必须在执照核定范围以及国家规定的操作权限内、进行短时间体验性发射操作实习	必须已接受法规等基础培训、必须由电台负责人现场辅导、必须在执照核定范围以及国家规定的操作权限内、进行短时间体验性发射操作实习
LK0065 业余无线电台设置人应对其无线电发射设备担负的法定责任为：<br>应当确保其无线电发射设备达到最大发射功率，以克服其他无线电业务的干扰<br>应当确保其无线电发射设备处于正常工作状态，避免对其他无线电业务造成有害干扰<br>应当确保其无线电发射设备随最先进型号更新，为其他业余电台树立求新的榜样<br>应当确保其无线电发射设备经常处于工作状态，以提高业余频率的实际占用度	应当确保其无线电发射设备处于正常工作状态，避免对其他无线电业务造成有害干扰
LK0066 业余无线电爱好者使用业余无线电收信设备应遵守的规定为：<br>只要出于个人对信息的兴趣而不涉及赢利，可以接收任何无线电信号<br>不得接收与业余业务和卫星业余业务无关的信号<br>只要不被查出来，可以接收任何无线电信号<br>只要不造成对其他业务的无线电干扰，接收无线电信号没有限制	不得接收与业余业务和卫星业余业务无关的信号
LK0067 业余无线电爱好者无意接收到非业余业务和卫星业余业务的信息时，应遵守的规则为：<br>只可以在业余无线电台间共享，不得在其他场合公开<br>只可以用非无线电方式在业余无线电爱好者之间交流，不得以无线电方式转发<br>不得传播、公布<br>既然自己可以收到，别人也一定可以收到，当然可以传播、公布或者利用	不得传播、公布
LK0068 业余无线电台是否可以发射从广播电台收到的信号、音像节目的录音，或者故意转送电台周围的声音？<br>可以，因为该类信息没有保密性<br>可以，用于显示自己发射设备的信号质量<br>不可以，不得发送与业余业务和卫星业余业务无关的信号<br>可以，用于提起其他有业余无线电台操作员精神，防止乏困	不可以，不得发送与业余业务和卫星业余业务无关的信号
LK0069 国家对于利用业余无线电台从事发布、传播违反法律或者公共道德的信息的行为的态度是；<br>不提倡<br>不可以发布传、播违法信息。但违反公共道德的信息属于水平问题，不鼓励就是了<br>容忍<br>禁止	禁止
LK0070 出租车安装业余电台并用来传递有关载客的信息，这种行为的性质是：<br>只要管理部门不来查处就可以<br>只要不影响其他业余电台的正常通信就可以<br>不太好，因为占用了其他业余电台通信的频率<br>违法行为，违反了严禁利用业余无线电台从事从事商业或者其他营利活动的规定	违法行为，违反了严禁利用业余无线电台从事从事商业或者其他营利活动的规定
LK0071 利用业余无线电台通信来促销业余无线电产品或者推动与业余无线电活动有关的其他商业性活动，对这类行为的态度应该是：<br>不提倡但也不禁止，毕竟有利于业余无线电活动发展<br>禁止<br>如果设台人或者设台单位本身是以这类经营为生的，应适当理解和容忍<br>只要是业余无线电民间组织是获利方，即使从事商业或其他营利活动，应支持	禁止
LK0072 利用自己的业余电台强信号故意压制其他业余电台的正常通信，或者在业余无线电频率上转播音乐或广播节目，这些行为的性质属于：<br>违法行为，违反了严禁阻碍其他无线电台通信的规定<br>不文明行为，对其他业余电台不够礼貌<br>正常现象，社会上一些人素质就是如此，应该谅解<br>不妥行为，没有考虑到他人的乐趣	违法行为，违反了严禁阻碍其他无线电台通信的规定
LK0073 业余无线电活动是否有序开展，会影响整个社会的无线电通信的安全和有效，使用不当甚至会导致生命财产损失。业余无线电爱好者在这方的法定责任是：<br>个人没有责任，只能依靠业余无线电民间组织充当“协管”<br>业余无线电台设置、使用人应当加强自律<br>有了电台执照，日常一切言行当然可以带到电台通信中，无责任可言<br>个人没有责任，只能依靠管理部门的监督检查和违法查处	业余无线电台设置、使用人应当加强自律
LK0181 国际电联规定的确定发射电台辐射功率的原则为：<br>HF频段发射电台应辐射尽量大的功率，VHF频段发射电台应辐射尽量小的功率<br>VHF/UHF频段发射电台应辐射尽量大的功率，HF频段发射电台应辐射尽量小的功率<br>发射电台应辐射尽量大的功率以提供尽量好的信号质量<br>发射电台只应辐射为保证满意服务所必要的功率	发射电台只应辐射为保证满意服务所必要的功率
LK0247 业余电台通信受到违法电台或者不明电台的有害干扰。正确的做法是：<br>立即报告无线电管理机构进行干涉<br>用大功率信号对其进行压制<br>在频率上向其宣传无线电管理法，要求其停止干扰<br>不予理睬，收集有关信息并向无线电管理机构举报	不予理睬，收集有关信息并向无线电管理机构举报
LK1010 按照我国规定，购置使用公众对讲机不需取得批准。业余无线电爱好者需要与公众对讲机用户通信时应该：<br>业余无线电台不能用于与公众对讲机通信<br>将业余无线电台设置到公众对讲机的频率，以不大于业余无线电台执照核定的发射功率与之通信<br>将业余无线电台设置到公众对讲机的频率，以不大于0.5W的发射功率与之通信<br>将业余无线电台设置到公众对讲机的频率，但只能进行由业余无线电台到公众对讲机的单向发信	业余无线电台不能用于与公众对讲机通信
LK0053 关于业余无线电台的应急通信，正确的叙述是：<br>在日常应急通信训练中，业余无线电台可以和地方公益性救援团体的非业余无线电台进行通信<br>在日常应急通信训练中，业余无线电台可以和各种非业余无线电台进行通信<br>在日常应急通信训练中，业余无线电台可以和地方公益性救援团体的非业余无线电台进行通信，但须经当地业余无线电协会同意<br>在突发重大自然灾害等紧急情况下，业余无线电台才可以和非业余无线电台进行规定内容的通信	在突发重大自然灾害等紧急情况下，业余无线电台才可以和非业余无线电台进行规定内容的通信
LK0054 业余无线电台允许与非业余无线电台通信的条件是：<br>在无线电技术研究中，仅可与具备其他业务电台执照的对象通信，内容限于技术实验所需的信号<br>在当地政府或非盈利机构组织的公益活动中，内容限于与公益事务或者相关的活动组织机构交办的任务<br>在突发重大自然灾害等紧急情况下，内容限于与抢险救灾直接相关的紧急事务或者应急救援相关部门交办的任务<br>在青少年科技教育活动中，仅可与青少年非业余无线电台通信，内容限于与青少年科技教育直接有关的事务	在突发重大自然灾害等紧急情况下，内容限于与抢险救灾直接相关的紧急事务或者应急救援相关部门交办的任务
LK0055 关于业余无线电台的应急通信，正确的叙述是：<br>在日常公益性社会活动中，业余无线电台的通信内容可以涉及各种公益机构交办的任务<br>在突发重大自然灾害等紧急情况下，业余无线电台的通信内容可以涉及应急救援相关部门交办的任务<br>在平时的任何时侯，业余无线电台的通信内容可以涉及任何政府组织和非盈利机构交办的任务<br>平时在专门的应急通信训练活动中，业余无线电台的通信内容可以涉及应急救援相关部门和组织机构交办的任务	在突发重大自然灾害等紧急情况下，业余无线电台的通信内容可以涉及应急救援相关部门交办的任务
LK0075 法规和国际业余无线电惯例要求业余电台日志记载的必要基本内容是：<br>通信时间、通信模式、对方信号报告、对方台址、对方天气<br>通信时间、通信频率、双方收发信设备和天线、对方台址<br>通信时间、通信频率、通信模式、对方呼号、双方信号报告<br>通信对方姓名、对方所在国家或城市、通信模式、双方信号报告	通信时间、通信频率、通信模式、对方呼号、双方信号报告
LK0076 法规和国际业余无线电惯例要求业余电台日志记载的必要基本内容是：<br>DATE、FREQ、QTH（对方）、RIG（对方）、RST（双方）、WX（对方）<br>CALL（通信对方）、T IME、FREQ、RIG（对方）、RST（双方）、PWR（双方）<br>DATE、TIME、FREQ、MODE、CALL（对方）、RST（双方）<br>DATE、TIME、MODE、CALL（对方）、QTH（对方）、RST（双方）	DATE、TIME、FREQ、MODE、CALL（对方）、RST（双方）
LK1011 填写和邮寄QSL卡片时的正确做法有：<br>自己的邮寄地址与电台的发射地点不同时，应在QTH栏目内填明详细邮寄地址<br>迫切需要方卡回寄卡片时，应直接向对方地址邮寄卡片并附加SASE<br>通过卡片管理局寄出卡片并希望对方回卡时，应在卡片上注明PSE QSL DIRECT<br>填写错误时应划去或使用涂改液覆盖错误内容并加以改正	迫切需要方卡回寄卡片时，应直接向对方地址邮寄卡片并附加SASE
LK1042 关于QSL卡片的正确用法是：<br>如果在联络中没有听清对方呼号，可以在寄发QSL卡片的对方台名栏中填写对方操作员姓名<br>出于火腿互相帮助的目的，虽然对方没有联络到自己，也可以发去确认联络的QSL卡片<br>空白QSL卡片可以当做照片或者名片，任意赠送、交换、散发<br>不是作为联络或收听证明而交换QSL卡片时，应填上“Eye ball QSO”等有关说明，不应赠送空白卡片	不是作为联络或收听证明而交换QSL卡片时，应填上“Eye ball QSO”等有关说明，不应赠送空白卡片
LK0034 业余中继台的设置和技术参数等应满足下列关键条件：<br>符合设台地的地方业余无线电民间组织的规划<br>符合申请人关于设置中继台的客观需求和技术考虑<br>符合国家以及设台地的地方无线电管理机构的规定<br>仅需符合设台地的地方无线电管理机构的规划及相关规定	符合国家以及设台地的地方无线电管理机构的规定
LK0035 业余中继台必备的技术措施为：<br>设专人负责监控和管理工作，配备有效的遥控手段，保证造成有害干扰时及时停止发射<br>设热备份系统，保证不间断工作<br>技术加密措施，防止未经设台人允许的业余无线电台启用中继<br>尽量提高发射功率，以便压制覆盖区内的其他强信号干扰	设专人负责监控和管理工作，配备有效的遥控手段，保证造成有害干扰时及时停止发射
LK0036 某团体依法设置了一部业余中继台。其正确做法是：<br>中继台是设台者出资建设和维护的，因此仅供经设置者允许的业余电台使用<br>向其覆盖区域内的所有业余无线电台提供平等的服务，并将使用业余中继台所需的各项技术参数公开<br>为保证中继台正常运行，要求覆盖区内所有业余电台缴纳维护成本，否则不准使用<br>中继台是设台者出资建设和维护的，因此仅供本团体成员优先使用，空闲时方供其他业余电台使用	向其覆盖区域内的所有业余无线电台提供平等的服务，并将使用业余中继台所需的各项技术参数公开
LK0037 选择144MHz或430MHz业余模拟调频中继台同频段收发频差的原则是：<br>采用业余无线电标准频差，即144MHz频段600kHz，430MHz频段5MHz<br>采用经常变换频差的办法减少占用度<br>可以在国家《无线电频率划分规定》所规定业余频率范围内任意选择<br>尽量采用非标准频差以阻止一般业余无线电台占用	采用业余无线电标准频差，即144MHz频段600kHz，430MHz频段5MHz
LK0275 业余中继台的使用原则是：<br>除必要的短暂通信外，应保持业余中继台具有足够的空闲时间，以便随时响应突发灾害应急呼叫<br>鼓励业余无线电民间组织（协会）通过中继台向当地会员发布通知<br>鼓励青少年学生通过中继台交流解题方法和学习心得<br>应使中继台尽量处于接近饱和的忙碌状态，提高使用效率	除必要的短暂通信外，应保持业余中继台具有足够的空闲时间，以便随时响应突发灾害应急呼叫
LK1096 如果你知道另一个电台的呼号，想要在中继上呼叫他，你应该怎么做？<br>呼叫“CQ”三次，然后说出对方的呼号<br>呼叫对方的呼号，并报出自己的呼号<br>等待，直到你要呼叫的电台呼叫CQ后，立刻回答他<br>呼叫“break break”，然后说出对方的呼号	呼叫对方的呼号，并报出自己的呼号
LK0074 业余无线电台设置、使用人应当接受下列机构对业余无线电台及其使用情况的监督检查：<br>单位或所在居委会、村民委员会、物主委员会的监督检查<br>无线电管理机构或者其委托单位的监督检查<br>国家计量监督部门的监督检查<br>业余无线电民间组织的独立监督检查	无线电管理机构或者其委托单位的监督检查
LK0094 对擅自设置、使用业余无线电台的单位或个人，国家无线电管理机构或者地方无线电管理机构可以根据其具体情况给予下列处罚：<br>劝告拆除非法设置的电台；情节严重的，可以并处警告、查封或者没收设备<br>责令停止使用非法设置的电台；情节严重的，可以并处警告、查封或者没收设备<br>警告、查封或者没收设备、没收非法所得；情节严重的，可以并处一千元以上，五千元以下的罚款<br>责令停止使用非法设置的电台并作出书面检查；情节严重的，可以并处一千元以下的罚款	警告、查封或者没收设备、没收非法所得；情节严重的，可以并处一千元以上，五千元以下的罚款
LK0095 业余电台干扰无线电业务的，国家无线电管理机构或者地方无线电管理机构可以根据其具体情况给予设置业余无线电台的单位或个人下列处罚：<br>警告、查封或者没收设备、没收非法所得；情节严重的，可以并处一千元以上，五千元以下的罚款<br>责令停止使用非法设置的电台；情节严重的，可以并处警告、查封或者没收设备<br>劝告拆除非法设置的电台；情节严重的，可以并处警告、查封或者没收设备<br>责令停止使用非法设置的电台并作出书面检查；情节严重的，可以并处一千元以下的罚款	警告、查封或者没收设备、没收非法所得；情节严重的，可以并处一千元以上，五千元以下的罚款
LK0096 业余电台随意变更核定项目、发送和接收与业余无线电无关的信号的，国家无线电管理机构或者地方无线电管理机构可以根据其具体情况给予设置业余无线电台的单位或个人下列处罚：<br>警告、查封或者没收设备、没收非法所得；情节严重的，可以并处一千元以上，五千元以下的罚款<br>责令停止使用非法设置的电台并作出书面检查；情节严重的，可以并处一千元以下的罚款<br>劝告拆除非法设置的电台；情节严重的，可以并处警告、查封或者没收设备<br>责令停止使用非法设置的电台；情节严重的，可以并处警告、查封或者没收设备	警告、查封或者没收设备、没收非法所得；情节严重的，可以并处一千元以上，五千元以下的罚款
LK0097 超出核定范围使用频率或者有其他违反频率管理有关规定的行为的，无线电管理机构可以根据其具体情况给予设置业余无线电台的单位或个人下列处罚：<br>责令限期改正，可以处警告或者三万元以下的罚款<br>责令限期改正，可以处警告或者一千元以下的罚款<br>责令限期改正，情节严重的，可以并处警告、查封或者没收设备<br>责令限期改正，可以处警告或者一千元以上，五千元以下的罚款	责令限期改正，可以处警告或者三万元以下的罚款
LK0098 对涂改、仿制、伪造、倒卖、出租、出借业余无线电台执照，或者以其他形式非法转让业余无线电台执照的，无线电管理机构可以给予下列处罚：<br>应当责令限期改正，可以处警告或者一千元以上，五千元以下的罚款<br>应当责令限期改正，情节严重的，可以并处警告、查封或者没收设备<br>应当责令限期改正，可以处警告或者三万元以下的罚款<br>应当责令限期改正，可以处警告或者一千元以下的罚款	应当责令限期改正，可以处警告或者三万元以下的罚款
LK0099 对盗用、出租、出借、转让、私自编制或者违法使用业余无线电台呼号的，无线电管理机构可以给予下列处罚：<br>应当责令限期改正，可以处警告或者三万元以下的罚款<br>应当责令限期改正，可以处警告或者一千元以上，五千元以下的罚款<br>应当责令限期改正，可以处警告或者一千元以下的罚款<br>应当责令限期改正，情节严重的，可以并处警告、查封或者没收设备	应当责令限期改正，可以处警告或者三万元以下的罚款
LK0100 对以不正当手段取得业余无线电台执照的，无线电管理机构可以给予下列处罚：<br>责令限期改正，情节严重的，可以并处警告、查封或者没收设备<br>责令限期改正，可以处警告或者三万元以下的罚款<br>责令限期改正，可以处警告或者一千元以下的罚款<br>责令限期改正，可以处警告或者一千元以上，五千元以下的罚款	责令限期改正，可以处警告或者三万元以下的罚款
LK0101 对向负责监督检查的无线电管理机构隐瞒有关情况、提供虚假材料或者拒绝提供反映其活动情况的真实材料的，无线电管理机构可以给予下列处罚：<br>责令限期改正，可以处警告或者三万元以下的罚款<br>责令限期改正，情节严重的，可以并处警告、查封或者没收设备<br>责令限期改正，可以处警告或者一千元以上，五千元以下的罚款<br>责令限期改正，可以处警告或者一千元以下的罚款	责令限期改正，可以处警告或者三万元以下的罚款
LK0102 对违法使用业余无线电台造成严重后果的，无线电管理机构可以给予下列处罚：<br>应当责令限期改正，可以处警告或者一千元以上，五千元以下的罚款<br>应当责令限期改正，可以处警告或者三万元以下的罚款<br>应当责令限期改正，情节严重的，可以并处警告、查封或者没收设备<br>应当责令限期改正，可以处警告或者一千元以下的罚款	应当责令限期改正，可以处警告或者三万元以下的罚款
LK0103 违反国家规定，擅自设置、使用无线电台（站），或者擅自占用频率，经责令停止使用后拒不停止使用，干扰无线电通信正常进行，造成严重后果的的，可被判犯扰乱无线电通信管理秩序罪，处三年以下有期徒刑、拘役或者管制，并处或者单处罚金。这个规定出自于下列法规律：<br>中华人民共和国电信法<br>中华人民共和国刑法<br>中华人民共和国民法通则<br>中华人民共和国无线电管理条例	中华人民共和国刑法
LK0105 无线电管制是指在下列范围内依法采取的对无线电波的发射、辐射和传播实施的强制性管理：<br>在例行范围和例行时间内<br>在特定时间和特定区域内<br>在特定范围、所有时间内<br>在全国范围、所有时间内	在特定时间和特定区域内
LK0106 无线电管制是指在特定时间和特定区域内，依法采取的下列性质的管理：<br>对无线电发射设备的生产、销售实施的强制性管理<br>对无线电波的发射、辐射和传播实施的强制性管理<br>对无线电波的发射、辐射实施的指导和行业自律性管理<br>对无线电发射设备的生产、销售实施的指导和行业自律性管理	对无线电波的发射、辐射和传播实施的强制性管理
LK0107 在特定时间和特定区域内实施无线电管制时，与业余无线电有关的管理措施包括：<br>依法设置的业余电台不在管制范围之内<br>限制、但不会禁止业余无线电台（站）的使用<br>限制或者禁止业余无线电台（站）的使用，以及对特定的无线电频率实施技术阻断等<br>限制或者禁止业余无线电台设备的生产和销售	限制或者禁止业余无线电台（站）的使用，以及对特定的无线电频率实施技术阻断等
LK0108 决定实施无线电管制的机构为：<br>在全国范围内或者跨省、自治区、直辖市实施，由国家无线电管理机构决定。在省、自治区、直辖市范围内实施，由相关地方无线电管理机构决定<br>在地、市、县实施，由地、市、县人民政府决定<br>在全国范围内或者跨省、自治区、直辖市实施，由国务院和中央军事委员会决定。在省、自治区、直辖市范围内实施，由省、自治区、直辖市人民政府和相关军区决定<br>在单位、居民区实施，由单位上级业务主管机构和区人民政府共同决定	在全国范围内或者跨省、自治区、直辖市实施，由国务院和中央军事委员会决定。在省、自治区、直辖市范围内实施，由省、自治区、直辖市人民政府和相关军区决定
LK0109 违反无线电管制命令和无线电管制指令的，由下列机构依法进行处罚：<br>国家无线电管理机构或者省、自治区、直辖市无线电管理机构；违反治安管理规定者由公安机关处罚<br>所在军区派出的专门机构<br>当地业余无线电协会<br>城管、工商、交通联合执法	国家无线电管理机构或者省、自治区、直辖市无线电管理机构；违反治安管理规定者由公安机关处罚
LK0110 业余电台违反无线电管制命令和无线电管制指令的，可以依法规受到下列处罚：<br> 处警告或者三万元以下的罚款<br> 处警告或者一千元以上，五千元以下的罚款 <br> 责令改正；拒不改正的，关闭、查封、暂扣或者拆除相关设备；情节严重的，吊销电台执照；违反治安管理规定的，由公安机关处罚<br> 责令改正；并开除业余无线电协会会籍、罚没无线电通信设备	 责令改正；拒不改正的，关闭、查封、暂扣或者拆除相关设备；情节严重的，吊销电台执照；违反治安管理规定的，由公安机关处罚
LK0050 某俱乐部约定了一个成员业余电台之间交流技术的网络频率，当遇有其他业余电台按通信惯例要求参加通信时，处理原则应为：<br>无条件欢迎加入，因为任何核准的业余电台对频率享有平等的频率使用权<br>要求其他业余电台在俱乐部成员结束网络通信后再使用该频率<br>要求其他业余电台在任何时间都不得使用俱乐部自己约定的专用通信频率<br>由俱乐部网络控制台决定是其他业余电台是否可以加入	无条件欢迎加入，因为任何核准的业余电台对频率享有平等的频率使用权
LK0232 业余电台在发起呼叫前不可缺少的操作步骤是：<br>检查发射功率是否达到设备的额定输出功率<br>先用礼貌的语言请其他电台让出频率<br>先用吹话筒、吹口哨等方法发出连续信号检查天线驻波比<br>先守听一段时间，确保没有其他电台正在使用频率	先守听一段时间，确保没有其他电台正在使用频率
LK0233 业余电台在发射调试信号进行发射功率和天线驻波比等检查时必须注意做到的是：<br>先将频率设置到无人使用的空闲频率、偏离常用的热点频率<br>先将天线的发射方向指向正北<br>话筒离嘴距离在2公分以上，电键按键时间不短于5秒钟<br>先将收发信机的语音压缩功能打开	先将频率设置到无人使用的空闲频率、偏离常用的热点频率
LK0235 业余电台通过守听，没有听到信号还不足以确认频率空闲，因为有时听不到通信双方中的另一方，贸然呼叫会对已有的通信造成干扰。为避免这种情况，应该：<br>先询问“有人使用频率吗”？确认没有应答方能发起呼叫<br>可以先启动呼叫和进行通信，等听到确实有电台先占用频率，再主动让出<br>因为守听没有听到别人的信号，可以放心发起呼叫<br>可以先启动呼叫和进行通信，只要没有其他电台出来交涉就可放心使用	先询问“有人使用频率吗”？确认没有应答方能发起呼叫
LK0236 业余电台发起呼叫前应先守听一段时间，如没有听到信号，应再询问“有人使用频率吗”？确认没有应答方能发起呼叫。下列英语短句中不能正确表达这一询问的是：<br>Is any body in the frequency？<br>Is the frequency in use？<br>Any body here？<br>Calling you, Roger？	Calling you, Roger？
LK0238 业余电台BH1ZZZ用话音发起CQ呼叫的正确格式为：<br>CQ、CQ、CQ。我是1ZZZ。听到请回答<br>CQ、CQ、CQ。BH1ZZZ呼叫。Bravo Hotel One Zulu Zulu Zulu呼叫，BH1ZZZ呼叫。听到请回答。<br>CQ、CQ、CQ，CQ、CQ、CQ，CQ、CQ、CQ。BH1ZZZ呼叫。请过来。<br>CQ、CQ、CQ。听到请回答。	CQ、CQ、CQ。BH1ZZZ呼叫。Bravo Hotel One Zulu Zulu Zulu呼叫，BH1ZZZ呼叫。听到请回答。
LK0239 业余电台BH1ZZZ用话音发起CQ呼叫的正确格式为：<br>CQ CQ CQ, CQ CQ CQ, CQ CQ CQ. This is BH1ZZZ. Back to you.<br>CQ CQ CQ. This One Zulu Zulu Zulu. Over.<br>CQ CQ CQ. Go ahead please.<br>CQ CQ CQ.This is BH1ZZZ. Bravo Hotel One Zulu Zulu Zulu, BH1ZZZ is calling. I’m standing by.	CQ CQ CQ.This is BH1ZZZ. Bravo Hotel One Zulu Zulu Zulu, BH1ZZZ is calling. I’m standing by.
LK0241 业余电台BH1ZZZ用话音呼叫BH8YYY的正确格式为：<br>BH8YYY、BH8YYY、BH8YYY。BH1ZZZ呼叫。Bravo Hotel One Zulu Zulu Zulu，BH1ZZZ呼叫。听到请回答。<br>BH8YYY。我是BH1ZZZ，我是BH1ZZZ，我是BH1ZZZ。听到请回答。<br>BH8YYY、BH8YYY、BH8YYY。我是1ZZZ。听到请回答<br>8YYY、8YYY、8YYY。BH1ZZZ呼叫。请过来。	BH8YYY、BH8YYY、BH8YYY。BH1ZZZ呼叫。Bravo Hotel One Zulu Zulu Zulu，BH1ZZZ呼叫。听到请回答。
LK0242 业余电台BH1ZZZ用话音呼叫BH8YYY的正确格式为：<br>Bravo Hotel Eight Yankee Yankee Yankee, Bravo Hotel Eight Yankee Yankee Yankee, Bravo Hotel Eight Yankee Yankee Yankee. Go ahead please.<br>8YYY, 8YYY, YYY. This is BH1ZZZ. Over.<br>BH8YYY, BH8YYY, BH8YYY. This One Zulu Zulu Zulu. Come in please.<br>Bravo Hotel Eight Yankee Yankee Yankee, Bravo Hotel Eight Yankee Yankee Yankee, Bravo Hotel Eight Yankee Yankee Yankee.This is Bravo Hotel One Zulu Zulu Zulu. Bravo Hotel One Zulu Zulu Zulu, Bravo Hotel One Zulu Zulu Zulu is calling. I’m standing by.	Bravo Hotel Eight Yankee Yankee Yankee, Bravo Hotel Eight Yankee Yankee Yankee, Bravo Hotel Eight Yankee Yankee Yankee.This is Bravo Hotel One Zulu Zulu Zulu. Bravo Hotel One Zulu Zulu Zulu, Bravo Hotel One Zulu Zulu Zulu is calling. I’m standing by.
LK0244 BH1ZZZ希望加入两个电台正在通信中的谈话，正确的方法为：<br>在双方对话的间隙，短暂发射一次“Break in！”或“插入！”，如得到响应，再说明本台呼号 “BH1ZZZ请求插入”，等对方正式表示邀请后，方能加入<br>在一方正在发射期间，短暂插入一次“Break in”，向正在收听的一方发出插入请求<br>短暂发射一次“Break in！”或“插入！”，如对方无反应，应加大功率反复作此发射<br>只要双方都是自己熟悉的业余电台操作员，可直接插入谈话，不必拘泥礼节	在双方对话的间隙，短暂发射一次“Break in！”或“插入！”，如得到响应，再说明本台呼号 “BH1ZZZ请求插入”，等对方正式表示邀请后，方能加入
LK0245 以请求插入的方式加入两个电台正在通信中的谈话，应满足的起码条件是：<br>确认自己的加入不会影响原通信双方的乐趣<br>自己拥有比原通信双方更有吸引力的谈话内容<br>自己的信号质量不亚于原通信双方<br>自己的操作技巧不亚于原通信双方	确认自己的加入不会影响原通信双方的乐趣
LK1046 业余电台之间进行通信，必须相互正确发送和接收的信息为：<br>本台呼号、对方呼号、QTH<br>本台呼号、对方呼号、信号报告<br>对方呼号、信号报告、设备情况<br>本台呼号、信号报告、QTH	本台呼号、对方呼号、信号报告
LK1097 如何回答一个CQ呼叫？<br>说：“CQ”，并报出对方的呼号<br>先报出自己的呼号，再报出对方的呼号<br>先给出信号报告，再报出自己的呼号<br>先报出对方的呼号，再报出自己的呼号	先报出对方的呼号，再报出自己的呼号
LK1098 当一部电台在呼叫CQ时，他的意思是？<br>呼叫重庆的电台<br>非特指地呼叫任何一部电台<br>只有被呼叫的电台可以回答，其他人不能回答<br>此电台正在测试天线，不需要任何电台回答这个呼叫	非特指地呼叫任何一部电台
LK1102 如果其他电台报告你在2米波段的信号刚才非常强，但是突然变弱或不可辨，这时你应当怎么做？<br>将你电台中的镍氢电池换成锂电池<br>打开哑音发射功能<br>请对方电台调整自己的静噪设置<br>稍稍移动一下自己的位置，有时信号无规律反射造成的多径效应可能导致失真	稍稍移动一下自己的位置，有时信号无规律反射造成的多径效应可能导致失真
LK1131 下列哪种方式可以让你快速切换到一个你经常使用的频率？<br>将这个频率作为一个频道存储在电台中<br>打开哑音输出<br>关闭哑音输出<br>使用快速扫描模式来切换到那个频率	将这个频率作为一个频道存储在电台中
LK0287 “谁在呼叫我”的业余无线电通信Q简语为：<br>QRA？<br>QRZ？<br>QRZ<br>QSL？	QRZ？
LK0292 “我遇到他台干扰”的业余无线电通信Q简语为：<br>QSB？<br>QRM<br>QRN<br>QSM	QRM
LK0294 “我遇到天电干扰”的业余无线电通信Q简语为：<br>QSN<br>QST<br>QRN<br>QRM	QRN
LK0313 “我给你收据（QSL卡片）、我已收妥”的业余无线电通信Q简语为：<br>QSL<br>QRV<br>QRG<br>QSX	QSL
LK0321 “我的电台位置是××××”的业余无线电通信Q简语为：<br>QSL　××××<br>QSP　××××<br>QTH　××××<br>QRD　××××	QTH　××××
LK0331 “天线”的业余无线电通信常用缩语是：<br>ATN<br>ANT<br>ATR<br>ATT	ANT
LK0332 业余无线电常用缩语“ARDF”的意思是：<br>地址<br>天线调谐器、天调<br>业余无线电测向<br>天线测试仪	业余无线电测向
LK0352 “频率”的业余无线电通信常用缩语是：<br>FREQ<br>FER<br>TUNE<br>FIND	FREQ
LK0361 业余无线电通信常用缩语“GND”的意思是：<br>好运气<br>高兴<br>地线，地面<br>格林威治时间	地线，地面
LK0373 业余无线电通信常用缩语“OM”的意思是：<br>老朋友<br>或者<br>老人<br>欧姆	老朋友
LK0376 “电台设备”的业余无线电通信常用缩语是：<br>EQP<br>REG<br>SB<br>RIG	RIG
LK0379 “收信机”的业余无线电通信常用缩语是：<br>XCVR<br>RCVR，RX<br>RMKS<br>XMTR	RCVR，RX
LK0380 “发信机”的业余无线电通信常用缩语是：<br>TX、XMTR<br>XTL<br>VXCO<br>VXO	TX、XMTR
LK0381 “收发信机”的业余无线电通信常用缩语是：<br>XCVR<br>XTL<br>XVTR<br>XMTR	XCVR
LK0396 业余无线电通信常用缩语“WX”的意思是：<br>瓦特<br>天气<br>联络、工作<br>星期	天气
LK0402 业余无线电通信常用缩语“73”的意思是：<br>希望下次再见<br>谢谢你<br>再见<br>向对方的致意、美好的祝愿	向对方的致意、美好的祝愿
LK0404 业余无线电通话常用语“Roger”的用法是：<br>回答起始语，相当于“明白”，仅在已完全抄收对方刚才发送的信息时使用<br>惯用口头语，相当于电话的“喂”，仅提起注意，不包含任何意义<br>回答起始语，相当于“听到”，用于能听到对方信号、但不一定能全部抄收的情况<br>回答起始语，表示开始发话了，任何情况都可使用	回答起始语，相当于“明白”，仅在已完全抄收对方刚才发送的信息时使用
LK0405 业余无线电通信中常用的天线种类的缩写DP代表：<br>长线天线<br>偶极天线<br>定向天线<br>垂直天线	偶极天线
LK0407 业余无线电通信中常用的天线种类的缩写GP代表：<br>垂直接地天线<br>定向天线<br>偶极天线<br>对数周期天线	垂直接地天线
LK0408 业余无线电通信中常用的天线种类的缩写BEAM代表：<br>垂直天线<br>定向天线<br>偶极天线<br>专指八木天线	定向天线
LK0409 业余无线电通信中常用的天线种类的缩写YAGI代表：<br>定向天线<br>垂直天线<br>偶极天线<br>八木天线	八木天线
LK0410 业余无线电通信中常用的天线种类的缩写VER代表：<br>定向天线<br>垂直天线<br>偶极天线<br>垂直接地天线	垂直天线
LK0193 已知北京时间，相应的UTC时间应为：<br>北京时间的小时数减8，如小时数小于0，则小时数加24，日期改为前一天。<br>北京时间的小时数加8，如小时数大于24，则小时数减24，日期改为前一天。<br>北京时间的小时数加8，如小时数大于24，则小时数减24，日期改为后一天。<br>北京时间的小时数减8，如小时数小于0，则小时数加24，日期改为后一天。	北京时间的小时数减8，如小时数小于0，则小时数加24，日期改为前一天。
LK0194 已知UTC时间，相应的北京时间应为：<br>北京时间的小时数减8，如小时数小于0，则小时数加24，日期改为后一天。<br>北京时间的小时数减8，如小时数小于0，则小时数加24，日期改为前一天。<br>UTC时间的小时数加8，如小时数大于24，则小时数减24，日期改为后一天。<br>北京时间的小时数加8，如小时数大于24，则小时数减24，日期改为前一天。	UTC时间的小时数加8，如小时数大于24，则小时数减24，日期改为后一天。
LK0202 我国所属的“CQ分区”有：<br>23、24<br>42、43、44、50<br>42、43、44<br>23、24、27	23、24、27
LK0204 “ITU分区”是IARU的活动计算通信成绩的基础。我国所属的“ITU分区”有：<br>23、24、27<br>23、24<br>33、42、43、44、50<br>33、42、43、44	33、42、43、44、50
LK0862 业余无线电通信梅登海德网格定位系统（Maidenhead Grid Square Locator）是一种：<br>卫星定位系统<br>根据国际政治行政区划对地球表面进行网格划分和命名，用以标示地理位置的系统<br>根据经纬度坐标对地球表面进行网格划分和命名，用以标示地理位置的系统<br>根据国际呼号系列对地球表面进行网格划分和命名，用以标示地理位置的系统	根据经纬度坐标对地球表面进行网格划分和命名，用以标示地理位置的系统
LK0863 业余无线电通信常用的梅登海德网格定位系统网格名称的格式为：<br>4个字母或者6个字母<br>2个字母和2位数字、2个字母和2位数字再加2个字母<br>4位数字或者6位数字<br>呼号前缀字母加2位数字和2个字母	2个字母和2位数字、2个字母和2位数字再加2个字母
LK0864 业余无线电通信常用的梅登海德网格定位系统网格名称的长度是4字符或6字符，两者定位精度不同，差别为：<br>两者网格大小不同，4字符网格为经度2度和纬度1度，6字符网格为经度5分和纬度2.5分<br>4字符网格名称用于HF频段通信，6字符网格名称用于VHF/UHF通信<br>4字符网格精确到国家分区，6字符网格精确到国家的城市或县乡<br>4字符网格根据国际呼号系列区分，6字符网格在4字符基础上加以经纬度细分	两者网格大小不同，4字符网格为经度2度和纬度1度，6字符网格为经度5分和纬度2.5分
LK1208 业余无线电通信所说的“网格定位”是什么意思？<br>一个由一串字母和数字确定的方位角和仰角<br>用于无线电测向运动的设备<br>一个由一串字母和数字确定的地理位置<br>用来调谐末级功放的设备	一个由一串字母和数字确定的地理位置
LK0431 电流的单位是：<br>伏（特）<br>欧（姆）<br>安（培）<br>瓦（特）	安（培）
LK0432 电压的单位是：<br>安（培）<br>欧（姆）<br>瓦（特）<br>伏（特）	伏（特）
LK0433 电阻的单位是：<br>瓦（特）<br>伏（特）<br>欧（姆）<br>安（培）	欧（姆）
LK0434 功率的单位是：<br>欧（姆）<br>瓦（特）<br>伏（特）<br>安（培）	瓦（特）
LK0466 无线电常用度量单位的词头K的意义为：（”x＾m”表示“x的m次方”）<br>10＾(-6)<br>10＾6<br>10＾(-3)<br>10＾3	10＾3
LK0467 无线电常用度量单位的词头m的意义为：（”x＾m”表示“x的m次方”）<br>10＾6<br>10＾(-3)<br>10＾3<br>10＾(-6)	10＾(-3)
LK0468 无线电常用度量单位的词头M的意义为：（”x＾m”表示“x的m次方”）<br>10＾3<br>10＾(-6)<br>10＾6<br>10＾(-3)	10＾6
LK0469 无线电常用度量单位的词头μ的意义为：（”x＾m”表示“x的m次方”）<br>10＾3<br>10＾6<br>10＾(-6)<br>10＾(-3)	10＾(-6)
LK0470 无线电常用度量单位的词头G的意义分别为：（”x＾m”表示“x的m次方”）<br>10＾9<br>10＾6<br>10＾(-12)<br>10＾12	10＾9
LK0471 无线电常用度量单位的词头n的意义分别为：（”x＾m”表示“x的m次方”）<br>10＾9<br>10＾12<br>10＾(-9)<br>10＾(-12)	10＾(-9)
LK0472 无线电常用度量单位的词头T的意义分别为：（”x＾m”表示“x的m次方”）<br>10＾(-9)<br>10＾12<br>10＾-12<br>10＾9	10＾12
LK0473 无线电常用度量单位的词头p的意义分别为：（”x＾m”表示“x的m次方”）<br>10＾(-9)<br>10＾9<br>10＾(-12)<br>10＾12	10＾(-12)
LK0495 音频所指的频率范围大致是：<br>16Hz - 20kHz<br>16kHz - 20kHz<br>300Hz - 3000Hz<br>16kHz - 56kHz	16Hz - 20kHz
LK0566 5W可以表示为：<br>35dBμ<br>17dBm<br>37dBm<br>5dBW	37dBm
LK0567 0.25W可以表示为：<br>25dBm<br>54dBμ<br>36dBm<br>6dBW	54dBμ
LK0568 0.4kW可以表示为：<br>6000dBm<br>400dBm<br>86dBμ<br>34dBm	86dBμ
LK0438 电源两端电压的方向为：<br>与电源的电动势方向相同<br>从电源的正极到负极<br>从电源的负极到正极<br>取决于负载电阻和电源内阻的相对大小	从电源的正极到负极
LK0440 直流电路欧姆定律是说：<br>流过电阻的电流I，与两端的电压U成正比，与阻值R成反比<br>流过电阻的电流I，与两端的电压U成正比，与阻值R成正比<br>流过电阻的电流I，与两端的电压U成反比，与阻值R成正比<br>流过电阻的电流I，与两端的电压U成反比，与阻值R成反比	流过电阻的电流I，与两端的电压U成正比，与阻值R成反比
LK0512 峰-峰值为100伏的正弦交流电压，其有效值电压为：<br>约141伏<br>约35.4伏<br>约50伏<br>约70.7伏	约35.4伏
LK0513 峰值为100伏的正弦交流电压，其有效值电压为：<br>约70.7伏<br>约35.4伏<br>约50伏<br>约141伏	约70.7伏
LK0518 峰-峰值为100伏的正弦交流电压，其平均值电压为：<br>约141伏<br>约35.4伏<br>约70.7伏<br>0	0
LK0519 峰值为100伏的正弦交流电压，其平均值电压为：<br>0<br>约70.7伏<br>约35.4伏<br>约141伏	0
LK0529 相位差通常用来描述：<br>两个或多个随机信号之间的时间滞后或超前关系<br>两个或多个同频率正弦信号之间的时间滞后或超前关系<br>两个或多个任意信号之间的幅度关系<br>两个或多个不同频率正弦信号之间的时间滞后或超前关系	两个或多个同频率正弦信号之间的时间滞后或超前关系
LK0537 电源（或信号源）内阻对电路的影响是：<br>使电源（或信号源）的实际输出电压降低<br>减少电源（或信号源）本身的电能消耗<br>使电源（或信号源）的电动势降低<br>使电源（或信号源）的可输出功率增加	使电源（或信号源）的实际输出电压降低
LK0577 电阻元件的“额定功率”参数是指：<br>该元件正常工作时所能承受的最大功率<br>该元件正常工作时必须正好消耗的功率<br>该元件正常工作时所需要的最小功率<br>该元件接入任何电路时的实际消耗功率	该元件正常工作时所能承受的最大功率
LK1107 下面哪一个术语可以用来描述交流电每秒改变方向的次数？<br>脉率<br>波长<br>频率<br>速率	频率
LK1134 电流使用下列哪一个单位来衡量？<br>瓦特<br>欧姆<br>安培<br>伏特	安培
LK1135 电功率使用如下哪一个单位来衡量？<br>伏特<br>安培<br>瓦特<br>欧姆	瓦特
LK1136 只向一个方向流动的电流叫做什么？<br>交流<br>平流<br>常流<br>直流	直流
LK1138 下列哪一项是电的良导体？<br>橡胶<br>木材<br>玻璃<br>铜	铜
LK1139 下列哪一项是电的良好绝缘体？<br>汞<br>铜<br>玻璃<br>铝	玻璃
LK1140 电能消耗的速率叫做什么？<br>电功率<br>电流<br>电阻<br>电压	电功率
LK0123 用通常的调频方式进行话音通信，必要带宽约为：<br>200Hz<br>12.5kHz<br>2700Hz<br>6.25kHz	6.25kHz
LK0138 无线电干扰中不属于有害干扰的是：<br>符合国家或国际上规定的干扰允许值和共用标准的干扰<br>一再阻断按规定正常开展的无线电通信业务的干扰<br>严重地损害、阻碍按规定正常开展的无线电通信业务的干扰<br>危害无线电导航或其他安全业务的正常运行的干扰	符合国家或国际上规定的干扰允许值和共用标准的干扰
LK0416 可以组成完整无线电接收系统的功能部件组合是：<br>接收天线、解调器、输出部件<br>接收天线、射频放大器、中频放大器<br>射频放大器、变频器、中频放大器<br>射频滤波器、变频器、音频滤波器	接收天线、解调器、输出部件
LK0417 可以组成完整无线电发信系统的功能部件组合是：<br>话音放大器、射频振荡器、射频功率放大器<br>射频振荡器、调制器、发射天线<br>键控电路、侧音电路、天线调谐器<br>射频振荡器、射频功率放大器、驻波测量电路	射频振荡器、调制器、发射天线
LK0418 无线电发射机调制部件的作用是：<br>调整天馈系统的参数达到阻抗匹配<br>自动控制发射信号的频谱使其保持在核准的必要带宽范围内<br>以电能转换效率最高的方式控制射频功率放大器的工作点<br>以原始信号控制射频信号的幅度、频率、相位参数	以原始信号控制射频信号的幅度、频率、相位参数
LK0420 发射天线的作用是：<br>把无线电发射机输出的射频信号电流转换为热能<br>把无线电发射机输出的射频信号电流转换为空间的电磁波<br>通过天线的增益对无线电发射机输出的射频信号加以放大<br>把无线电发射机放大后的音频话音信号转换为音频电磁场	把无线电发射机输出的射频信号电流转换为空间的电磁波
LK0421 接收天线系统的作用是：<br>把空间的有用电磁波转换为音频电压电流信号<br>把空间的有用电磁波转换为射频电压电流信号<br>把空间的有用电磁波转换为热能<br>通过天线的增益将空间有用电磁波的能量加以放大	把空间的有用电磁波转换为射频电压电流信号
LK0422 保证业余无线电通信接收机优良接收能力的主要因素是：<br>尽量宽的接收频率覆盖范围<br>尽量大的音频输出功率<br>尽量宽而平坦的音频频率响应<br>良好的抗干扰能力，足够高的灵敏度，尽量低的本机噪声和信号失真	良好的抗干扰能力，足够高的灵敏度，尽量低的本机噪声和信号失真
LK0533 一个频率为F的简单正弦波信号的频谱包含有：<br>频率为F的整数倍的无穷多个频率分量<br>频率为F的一个频率分量<br>无穷多个连续的频率分量<br>频率为F的奇数倍的无穷多个频率分量	频率为F的一个频率分量
LK0535 只包含一个频率分量的信号是：<br>连续的无限窄脉冲<br>简单正弦波<br>单个无限窄脉冲<br>对称方波	简单正弦波
LK0536 在整个频谱内具有连续的均匀频率分量的信号是：<br>单个无限窄脉冲<br>对称方波<br>简单正弦波<br>连续的无限窄脉冲	单个无限窄脉冲
LK0572 包含多个频率分量的信号通过滤波器会发生下列现象：<br>自激振荡<br>频率失真<br>检波<br>非线性失真	频率失真
LK0689 在给业余收发信机供电的整流电源中，开关电源可以做得比变压器直接降压整流的线性电源轻巧是因为：<br>开关电源使用了半导体器件，不需要变压器<br>开关电路中半导体元器件的损耗小，可以使用轻巧的小规格元器件<br>开关电源中变压器的工作频率高得多，可以缩小磁性材料截面和减少线圈匝数<br>开关电源使用轻质铝材做散热器，不需要通过笨重的铁芯变压器散热	开关电源中变压器的工作频率高得多，可以缩小磁性材料截面和减少线圈匝数
LK0713 一个FM话音信号在频谱仪上显示为：<br>多条固定的直线<br>一条固定的垂直线，左右伴随一组对称的随语音出现和变化的垂直线<br>一条随语音闪烁的直线<br>一条复杂的周期性曲线	一条固定的垂直线，左右伴随一组对称的随语音出现和变化的垂直线
LK0716 下列几种图表中，最容易用来表达和解释模拟FM调制原理的是：<br>相位矢量图<br>波形图<br>星座图和眼图<br>频谱图	频谱图
LK0784 业余无线电通信最常用的三种基本调制方法，其缩写AM、FM和PM，它们的中文名称分别是：<br>幅度调制（调幅）、频率调制（调频）、相位调制（调相）<br>频率调制（调频）、脉码调制（调脉码）、幅度调制（调幅）<br>幅度调制（调幅）、频率调制（调频）、电码调制（摩尔斯）<br>幅度调制（调幅）、频率调制（调频）、脉宽调制（调脉宽）	幅度调制（调幅）、频率调制（调频）、相位调制（调相）
LK0786 对于给定的FM发射设备，决定其射频输出信号实际占用带宽的因素是：<br>所传输信号的最高频率越高、幅度越大，射频输出占用带宽越宽<br>所传输信号的最高频率越高，射频输出占用带宽越宽，但与其幅度无关<br>所传输信号的幅度越大，射频输出占用带宽越宽，但与其频率无关<br>射频输出实际占用带宽为由电路决定的固定值，通信常用的是25kHz或12.5kHz	所传输信号的最高频率越高、幅度越大，射频输出占用带宽越宽
LK0791 什么叫做“鉴频”？<br>对调幅信号进行解调的过程称为鉴频<br>判断信号频率是否超过允许的频率范围的过程称为鉴频<br>判断信号频率是否发生了不应有的偏离或者漂移过程称为鉴频<br>对调频信号进行解调的过程称为鉴频	对调频信号进行解调的过程称为鉴频
LK0813 无线电发射机的效率是指：<br>输出到天线系统的有用信号功率与到达天线的包含杂散等无用信号的总功率之比<br>输出到天线系统的信号功率与发射机所消耗的电源功率之比<br>通信对象的接收天线得到的信号功率与发射机输出到天线系统的信号功率之比<br>通信对象的接收天线得到的信号功率与发射机所消耗的电源功率之比	输出到天线系统的信号功率与发射机所消耗的电源功率之比
LK0814 业余无线电发射机的效率总是明显低于1。所损耗的那部分能量：<br>绝大部分因阻抗失配而返回电源，极小部分转化为无用信号的电磁辐射<br>损耗的能量消失在电容、电感、开关器件等零部件中<br>绝大部分转化为杂散等无用信号的电磁辐射<br>绝大部分转化为热量，极小部分转化为无用信号的电磁辐射	绝大部分转化为热量，极小部分转化为无用信号的电磁辐射
LK0816 接收机灵敏度指标数值大小所反映的意义是：<br>灵敏度指标数值越小，对与有用信号同时出现的干扰信号的响应越灵敏<br>灵敏度指标数值越小，接收最小信号的能力越强<br>灵敏度指标数值越大，接收最小信号的能力越强<br>灵敏度指标数值越大，对与有用信号同时出现的干扰信号的响应越灵敏	灵敏度指标数值越小，接收最小信号的能力越强
LK0819 静噪灵敏度是指：<br>带有静噪功能的接收机开启静噪功能时，按照灵敏度定义测得的灵敏度<br>能够使静噪电路退出静噪状态的射频信号最小输入电平<br>带有静噪功能的接收机关闭静噪功能时，按照灵敏度定义测得的灵敏度<br>关闭静噪电路时所能接收到的最小射频信号的输入电平	能够使静噪电路退出静噪状态的射频信号最小输入电平
LK0854 “衰减”和“衰落”是无线电通信技术中常用的名词。它们的含义分别是指：<br>衰减和衰落是一回事，指信号通过信道或电路后发生幅度随时间而起伏<br>衰减和衰落是一回事，指信号通过信道或电路后功率减少<br>衰减是指信号通过信道或电路后发生幅度随时间而起伏，衰落是指信号通过信道或电路后功率减少<br>衰减是指信号通过信道或电路后功率减少，衰落是指信号通过信道或电路后发生幅度随时间而起伏	衰减是指信号通过信道或电路后功率减少，衰落是指信号通过信道或电路后发生幅度随时间而起伏
LK1044 无线电发信机在无调制情况下，在一个射频周期内供给天线馈线的平均功率称为：<br>平均功率<br>载波功率<br>峰包功率<br>无用功率	载波功率
LK1099 调频发射机在发射的语音信号上附加一个人耳听不到的低频音频，用来打开接收机的静噪。这一技术的常用名词是：<br>载波静噪<br>DTMF<br>CTCSS<br>单音频脉冲	CTCSS
LK1100 下列哪一项决定了FM信号的频偏？<br>取决于被调制信号的幅度<br>取决于被调制信号与载波之间的相位角关系<br>同时取决于被调制信号的频率和幅度<br>取决于被调制信号的频率	取决于被调制信号的幅度
LK1177 下列哪一项术语表述了接收机区分不同信号的能力？<br>灵敏度<br>选择性<br>本底噪声<br>扫描速度	选择性
LK1180 接收机“过载”通常是指：<br>由于接收机的音量调节得过大而导致的附加干扰<br>输入信号过于强大，以致导致机内产生附加干扰<br>接收机消耗的电流太大了<br>接收机电源的电压太高了	输入信号过于强大，以致导致机内产生附加干扰
LK1202 以下哪种语音调制常被用于长距离弱信号的VHF或UHF联络？<br>SSB<br>AM<br>FM<br>PM	SSB
LK1203 下列哪种调制被VHF和UHF业余电台本地通信广泛使用？<br>FM<br>AM<br>PSK<br>SSB	FM
LK0702 由半波长偶极天线和馈电电缆构成的天馈系统，理想的工作状态是：<br>天线上只有驻波，馈线上只有行波<br>天线和馈线上都只有行波<br>天线和馈线上都只有驻波<br>天线上只有行波，馈线上只有驻波	天线上只有驻波，馈线上只有行波
LK0904 在零仰角附近具有主辐射瓣的垂直接地天线，其振子的长度应为：<br>1/4波长的奇数倍<br>1/4波长的任意整数倍<br>1/4波长的偶数倍<br>1/2波长的奇数倍	1/4波长的奇数倍
LK0910 在为业余电台选购射频电缆作为天线馈线时，最重要的两项电气参数是：<br>铜或铝导线的截面积和常温下的最大额定电流<br>特性阻抗和工作频率下单位长度的传输功率损耗<br>长度为1/4波长、终端分别为开路和短路时的电压驻波比<br>导线绝缘层的耐压和最高额定环境温度	特性阻抗和工作频率下单位长度的传输功率损耗
LK0918 通常把垂直偶极天线或者垂直接地天线称为“全向天线”，是因为：<br>它们在水平方向没有指向性，但在立体空间有方向性<br>它们在水平方向和垂直方向都有指向性<br>它们在垂直方向没有指向性，但在立体空间有方向性<br>它们在空间没有指向性，向各个方向均匀辐射	它们在水平方向没有指向性，但在立体空间有方向性
LK0919 振子电气长度为1/4波长的垂直接地天线的最大辐射方向为：<br>在垂直方向没有指向性，在水平方向指向前方<br>在空间没有指向性，向各个方向均匀辐射<br>在水平方向呈现8字形方向特性<br>在水平方向没有指向性，在垂直方向指向水平面	在水平方向没有指向性，在垂直方向指向水平面
LK0925 垂直接地天线（GP）的构造为电气长度为1/4波长的垂直振子加一个“接地”反射体，因其简单而被大量应用于手持和车载业余电台，但这种天线的实际工作情况往往与理论值相差较大，尤其在频率较低的频段。最常见的原因和改善办法是：<br>缺乏有效的接地反射体。GP天线必须有足够大的接地反射体来形成振子镜像，否则谐振频率和阻抗都将与理论值有显著偏差，应尽量用大面积金属体与天线的接地端直接连接<br>1/4波长垂直振子太短。在振子中串联加感线圈即可解决问题<br>1/4波长垂直振子太短。改成1/2波长即可解决问题<br>一般天线与电缆直接相连，匹配不良。在天线和电联之间加接“巴伦”即可解决问题	缺乏有效的接地反射体。GP天线必须有足够大的接地反射体来形成振子镜像，否则谐振频率和阻抗都将与理论值有显著偏差，应尽量用大面积金属体与天线的接地端直接连接
LK0926 天线增益是指：<br>天线在接收或发射信号时所具有的放大倍数<br>天线辐射到空间的电磁波功率与输入到天线的总射频功率之比<br>输入到天线的总射频功率与天线辐射到空间的电磁波功率之比<br>天线在最大辐射方向上的辐射功率密度与相同条件下基准天线的辐射功率密度之比	天线在最大辐射方向上的辐射功率密度与相同条件下基准天线的辐射功率密度之比
LK0929 某商品天线说明书给出的增益指标以dBi为单位。其意义为：<br>“相对于垂直短天线的增益”，即以高度远小于波长的短垂直天线作为基准作为比较基准得到的天线增益<br>“相对于无方向性点源天线的增益”，即最大辐射方向上的辐射功率密度与理想点源天线的辐射功率密度之比<br>“相对于1/4波长接地天线的增益”，即以1/4波长垂直接地天线作为比较基准得到的天线增益<br>“相对于半波长偶极子天线的增益”，即最大辐射方向上的辐射功率密度与半波长偶极振子的最大辐射功率密度之比	“相对于无方向性点源天线的增益”，即最大辐射方向上的辐射功率密度与理想点源天线的辐射功率密度之比
LK0930 某商品天线说明书给出的增益指标以dBd为单位。其意义为：<br>“相对于1/4波长接地天线的增益”，即以1/4波长垂直接地天线作为比较基准得到的天线增益<br>“相对于半波长偶极子天线的增益”，即最大辐射方向上的辐射功率密度与半波长偶极振子的最大辐射功率密度之比<br>“相对于无方向性点源天线的增益”，即最大辐射方向上的辐射功率密度与理想点源天线的辐射功率密度之比<br>这种表达没有说清楚计算增益所采用的比较基准，缺乏实际意义	“相对于半波长偶极子天线的增益”，即最大辐射方向上的辐射功率密度与半波长偶极振子的最大辐射功率密度之比
LK0931 某商品天线说明书给出的增益指标以dB为单位。其意义为：<br>“相对于垂直短天线天线的增益”，即以高度远小于波长的短垂直天线作为基准作为比较基准得到的天线增益<br>“相对于半波长偶极子天线的增益”，即最大辐射方向上的辐射功率密度与半波长偶极振子的最大辐射功率密度之比<br>“相对于无方向性点源天线的增益”，即最大辐射方向上的辐射功率密度与理想点源天线的辐射功率密度之比<br>这种表达没有说清楚计算增益所采用的比较基准，缺乏实际意义	这种表达没有说清楚计算增益所采用的比较基准，缺乏实际意义
LK0932 两款VHF垂直全向天线，用作发射。甲天线增益4.5dBd，乙天线增益为5.85dBi。它们在远处某接收天线中形成的信号功率差为：<br>乙信号比甲信号强1.35dB<br>甲信号比乙信号强1.35dB<br>甲信号比乙信号强0.8dB<br>乙信号比甲信号强3.5dB	甲信号比乙信号强0.8dB
LK0933 两款VHF垂直全向天线，用作发射。甲天线增益2.9dBd，乙天线增益为5.85dBi。它们在远处某接收天线中形成的信号功率差为：<br>甲信号比乙信号强2.95dB<br>乙信号比甲信号强7.1dB<br>乙信号比甲信号强2.95dB<br>乙信号比甲信号强0.8dB	乙信号比甲信号强0.8dB
LK1062 以dBd为单位的天线增益则是指：<br>最大辐射方向辐射功率密度与半波长振子最大辐射方向辐射功率密度之比的dB值<br>最大辐射方向辐射功率密度与理想点源天线最大辐射方向辐射功率密度之比的dB值<br>最大辐射方向辐射功率密度与最小辐射方向辐射功率密度之比的dB值<br>最大辐射方向辐射功率密度与1/4波长垂直接地天线水平方向辐射功率密度之比的dB值	最大辐射方向辐射功率密度与半波长振子最大辐射方向辐射功率密度之比的dB值
LK1063 以dBi为单位的天线增益则是指：<br>最大辐射方向辐射功率密度与1/4波长垂直接地天线水平方向辐射功率密度之比的dB值<br>最大辐射方向辐射功率密度与最小辐射方向辐射功率密度之比的dB值<br>最大辐射方向辐射功率密度与半波长振子最大辐射方向辐射功率密度之比的dB值<br>最大辐射方向辐射功率密度与理想点源天线最大辐射方向辐射功率密度之比的dB值	最大辐射方向辐射功率密度与理想点源天线最大辐射方向辐射功率密度之比的dB值
LK1126 安装哪个部件可以减少在音频同轴电缆屏蔽层外皮中的感应射频电流？<br>在电缆芯线中串联带通滤波器<br>在电缆前端前置放大器<br>在电缆芯线中串联低通滤波器<br>在电缆外面套铁氧体磁环	在电缆外面套铁氧体磁环
LK1173 射频同轴电缆在业余电台中的主要用处是？<br>将无线电信号从发射机传送到天线<br>用来遮蔽天线塔上的支杆，管子等柱状物体<br>将信号从TNC传送到电脑<br>将电能从汽车的电池输送到移动车载电台	将无线电信号从发射机传送到天线
LK1183 假负载的主要作用是？<br>防止发射机过调制<br>增强接收机的信噪比<br>改善天线的辐射效率<br>在测试设备时不让无线电信号真正地发射出去	在测试设备时不让无线电信号真正地发射出去
LK1184 下列哪一个设备可以用来测定天线当前的谐振频率？<br>品质因数计<br>频率计数器<br>电子管电压表<br>天线分析仪	天线分析仪
LK1185 在业余无线电通信中，“驻波比”通常用来衡量：<br>电台接地的质量<br>负载与传输线的匹配质量<br>发射机的能效比<br>传输线的制造质量	负载与传输线的匹配质量
LK1186 天线与馈线完美匹配时，在驻波表中显示的驻波比是？<br>2:1<br>0<br>1:3<br>1:1	1:1
LK1188 馈线中的功率损耗会？<br>使驻波比增加<br>传回你的发射机并可能导致损害<br>变成热量<br>使你的信号失真	变成热量
LK1189 导致同轴电缆损害的最常见的原因是什么？<br>电缆受潮<br>伽马射线<br>过载<br>速度因子超过了1	电缆受潮
LK1190 为什么要求同轴电缆的外皮能抵挡紫外线？<br>紫外线和射频信号会混合在一起导致干扰<br>紫外线会使电缆外皮中的功率损耗加大<br>这样就可以减少谐波<br>紫外线能破坏电缆的外皮，使水分渗入	紫外线能破坏电缆的外皮，使水分渗入
LK1191 和固体电介质同轴电缆相比，空气电介质同轴电缆的劣势是什么？<br>空气电介质电缆不能在冰点以下使用<br>空气电介质电缆不能用于VHF或UHF段<br>空气电介质电缆的每米损耗更大<br>空气电介质电缆要采取特别的手段来防止水分进入电缆	空气电介质电缆要采取特别的手段来防止水分进入电缆
LK1211 下列关于直立天线的陈述，哪一项是正确的？<br>相位被倒转了<br>相位被反相了<br>该天线发射的电磁波磁场垂直于地面<br>该天线发射的电磁波电场垂直于地面	该天线发射的电磁波电场垂直于地面
LK1213 就大多数手持电台随机附送的“橡皮天线”来说，它的劣势是什么？<br>以上三项全部正确<br>相对于全尺寸天线，它的发射和接收效率较低<br>它发射的是圆极化的信号<br>如果橡胶的一头损坏了，那么它很快就会解体	相对于全尺寸天线，它的发射和接收效率较低
LK1216 天线的增益是什么意思？<br>相对于参考天线，发射或接收时的阻抗增加<br>当发射机在更高的频率发射时，天线会额外地减少一部分功率<br>相对于参考天线，在某一方向上信号强度的增加<br>对于发射机的功率输入，天线附加的一部分额外功率	相对于参考天线，在某一方向上信号强度的增加
LK1217 为什么在使用同轴电缆连接天线时，最好有一个较低的驻波比？<br>能延长发信机的使用寿命<br>使能量更有效率地传送，减少损耗<br>能延长天线的使用寿命<br>减少对电视的干扰	使能量更有效率地传送，减少损耗
LK1218 业余无线电普遍使用的同轴电缆的特性阻抗是？<br>600欧姆<br>8欧姆<br>12欧姆<br>50欧姆	50欧姆
LK1219 为什么同轴电缆在业余无线电界的使用相对于其他馈线来说更多？<br>因为它比其它任何一种馈线的损耗都低<br>因为它使用方便，与周围环境之间的相互影响小<br>因为它比其它任何一种馈线都便宜<br>因为它可以相对其它馈线传送更大的功率	因为它使用方便，与周围环境之间的相互影响小
LK1221 通过同轴电缆的信号频率越高，通常产生什么影响？<br>损耗越高<br>反射功率越高<br>特性阻抗越高<br>驻波比越高	损耗越高
LK1222 对于400MHz以上的信号，通常会使用的同轴电缆连接器是：<br>RS-213型连接器<br>N型连接器<br>DB-23型连接器<br>M型连接器	N型连接器
LK1223 下列哪一项有可能导致驻波比不稳定读数的？<br>发射机过调制<br>来自其他电台的干扰导致信号失真<br>发射机采用了频率调制<br>天线与馈线的连接头接触不良	天线与馈线的连接头接触不良
LK1224 下列馈线中，哪一种在VHF和UHF频段的损耗最小？<br>多芯不平衡电缆<br>50欧姆同轴软电缆<br>空气介质同轴硬电缆<br>75欧姆同轴软电缆	空气介质同轴硬电缆
LK0972 无线电波在真空中的速度大致为：（”x＾m”表示“x的m次方”）<br>3.1416×10＾12 米/秒<br>3×10＾8 米/秒<br>6.88×10＾6 米/秒<br>3×10＾7 米/秒	3×10＾8 米/秒
LK0973 天线工程中计算振子长度时需要知道电波在天线中的传播速度。电波在天线导线中的传播速度大约是：<br>真空波速的1.41倍<br>真空波速的0.95倍<br>真空波速的1.05倍<br>与真空波速相同	真空波速的0.95倍
LK0974 天线工程中计算馈线长度时经常需要知道电波在馈线中的传播速度。常用业余频段的电波在同轴电缆中的传播速度大约是：<br>与真空波速相同<br>真空波速的1.65倍<br>真空波速的0.65倍<br>真空波速的1.54倍	真空波速的0.65倍
LK1058 无线电波按传播方式可主要分为下列种类：<br>长波、中波、短波、超短波、微波等<br>调幅波、调频波、调相波等<br>正弦波、方波、三角波等<br>地面波、天波、空间波、散射波等	地面波、天波、空间波、散射波等
LK1060 无线电波在自由空间中的传播路径损耗遵循下列规律：<br>与距离的平方成正比，与频率的平方成反比，<br>与距离的平方成正比，与频率的平方成正比<br>与距离的平方成正比，与频率无关<br>与距离成正比，与频率的平方成正比	与距离的平方成正比，与频率的平方成正比
LK1067 地波是沿地面传播的无线电波，其衰减因子取决于：<br>天线高度、发射功率和调制方式<br>电波频率、太阳活动情况和地磁活动情况<br>电波频率、发射功率和天线增益<br>电波频率、地面导电率和传播距离	电波频率、地面导电率和传播距离
LK1068 决定超短波视距传播距离极限的主要因素是：<br>发射天线和接收天线的增益<br>发射天线和接收天线离地面的相对于波长的高度系数，即离地高度除以波长<br>发射天线和接收天线离地面的相对高度值<br>发射天线和接收天线离海平面的绝对高度值	发射天线和接收天线离地面的相对高度值
LK1104 多径传播对UHF波段或VHF波段数据通信的影响是：<br>如果使用FM方式调制的话，不会观察到任何反常现象<br>随着传播路径的增加，数据通信速率会线性地增加<br>可能使误码率增大<br>随着传播路径的增加，接收到的数据速率会线性地减小	可能使误码率增大
LK1106 在一个周期内，电磁波走过一定的距离，这个距离叫做：<br>波展<br>波长<br>波速<br>波形	波长
LK1108 无线电波的两个组成部分是？<br>直流和交流<br>电场和磁场<br>电离辐射和非电离辐射<br>电压和电流	电场和磁场
LK1109 无线电波的传播速度有多快？<br>和它的波长成反比例关系<br>速度随着频率的增加而增加<br>和音速一样<br>和光速一样	和光速一样
LK1110 无线电波的频率和它的波长有什么样的关系？<br>如果频率增加，则波长变长<br>波长与频率之间没有固定的联系<br>如果频率增加，则波长变短<br>该电磁波的波长取决于信号所占的带宽	如果频率增加，则波长变短
LK1111 在已知电磁波频率的情况下，下面哪一种方法可以用来计算它的波长？<br>将频率的赫兹数（Hz）除以300可以得到以米为单位的波长<br>使用频率的赫兹数（Hz）乘以300可以得到以米为单位的波长<br>使用300除以频率的兆赫数（MHz）可以得到以米为单位的波长<br>将频率的兆赫数（MHz）除以300可以得到以米为单位的波长	使用300除以频率的兆赫数（MHz）可以得到以米为单位的波长
LK1115 在自由空间中，无线电波的速度约是多少？<br>300000000米/每秒<br>18600英里/每小时<br>300000英里/每小时<br>3000千米/每秒	300000000米/每秒
LK1116 如果你收到了一个从上千公里以外的距离传播过来的VHF信号，最可能的原因是：<br>信号被附近的雷雨区反射过来<br>信号经过了宇宙的反射<br>信号经过了地下传输过来<br>信号被突发E电离层反射过来	信号被突发E电离层反射过来
LK1143 下列哪一个缩写经常在无线电工程文章中用来代表各种类型的无线电波？<br>AF<br>VHF<br>HF<br>RF	RF
LK1144 在空间中传播的电磁波，一般被叫做什么？<br>压力波<br>重力波<br>无线电波<br>声波	无线电波
LK0255 收发信机面板上或设置菜单中的符号VOX代表什么功能？<br>发信自动音量控制，对音频输入电平进行检测并反馈控制，以维持其在适当限度之内<br>发信机声控，接入后将根据对话筒有无语音输入的判别自动控制收发转换<br>自动天线调谐，对天线电路的电压驻波比进行检测并进行自动补偿，以维持最小驻波比<br>发信自动电平控制，对射频输出电平进行检测并反馈控制，以维持其在适当限度之内	发信机声控，接入后将根据对话筒有无语音输入的判别自动控制收发转换
LK0258 收发信机中的PTT是指什么信号？<br>自动天线调谐，对天线电路的电压驻波比进行检测并进行自动补偿，以维持最小驻波比<br>收信机前置放大器，在接收微弱信号时接入（此时某些技术指标可能低于额定值）<br>发信语音压缩，对音频输入电平进行检测并反馈控制，以提升语音包络幅度较小的部分<br>按键发射，有信号（一般为对地接通）时发射机由等待转为发射	按键发射，有信号（一般为对地接通）时发射机由等待转为发射
LK0259 收发信机面板上或设置菜单中的符号SQL代表什么功能？<br>自动天线调谐，对天线电路的电压驻波比进行检测并进行自动补偿，以维持最小驻波比<br>发信语音压缩，对音频输入电平进行检测并反馈控制，以提升语音包络幅度较小的部分<br>收信机前置放大器，在接收微弱信号时接入（此时某些技术指标可能低于额定值）<br>静噪控制，检测到接收信号低于一定电平时关断音频输出	静噪控制，检测到接收信号低于一定电平时关断音频输出
LK0260 有些调频接收机的参数设置菜单有NFM和WFM两种选择。它们的含义是：<br>NFM为调频通信本地方式（较低灵敏度），WFM为调频通信远程方式（最高灵敏度）<br>NFM为单频率守候方式，WFM为双频率守候方式<br>NFM为窄带调频方式，适用于信道带宽25kHz/12.5kHz的通信信号；WFM为宽带调频方式，适用于接收信道带宽180kHz左右的广播信号<br>NFM代表数字化语音方式，WFM代表模拟语音方式	NFM为窄带调频方式，适用于信道带宽25kHz/12.5kHz的通信信号；WFM为宽带调频方式，适用于接收信道带宽180kHz左右的广播信号
LK0261 某些对讲机具有发送DTMF码的功能。缩写DTMF指的是：<br>数字设备识别码，即在松开PTT按键时自动发送一串代表设备代号的二进制数据<br>自动静噪，即在接收机没有收到信号时自动关闭音频输出<br>双音多频编码，由8个音调频率中的两个频率组合成的控制信号，代表16种状态之一，用于遥控和传输数字等简单字符<br>亚音调静噪，即从67-250.3Hz的38个亚音调频率中选取一个作为选通信号，代表38种状态之一，接收机没有收到特定的选通信号时自动关闭音频输出	双音多频编码，由8个音调频率中的两个频率组合成的控制信号，代表16种状态之一，用于遥控和传输数字等简单字符
LK0262 某些对讲机具有发送CTCSS码的功能。缩写CTCSS指的是：<br>亚音调静噪，即从67-250.3Hz的38个亚音调频率中选取一个作为选通信号，代表38种状态之一，接收机没有收到特定的选通信号时自动关闭音频输出<br>双音多频编码，由8个音调频率中的两个频率组合成的控制信号，代表16种状态之一，用于遥控和传输数字等简单字符<br>自动静噪，即在接收机没有收到信号时自动关闭音频输出<br>数字设备识别码，即在松开PTT按键时自动发送一串代表设备代号的二进制数据	亚音调静噪，即从67-250.3Hz的38个亚音调频率中选取一个作为选通信号，代表38种状态之一，接收机没有收到特定的选通信号时自动关闭音频输出
LK0783 关于是否可以在FM话音通信时单凭接收机听到对方语音的音量大小来准确判断对方信号的强弱，正确答案及其理由是：<br>不能。因为鉴频输出大小只取决于射频信号的频偏，而且正常信号的幅度会被限幅电路切齐到同样大小<br>不能。因为信号越强，自动增益控制作用也越强，增益的急剧减小使声音反而被压低<br>能。调频信号越强，频偏也必然越大，解调后的声音也越大<br>能。最后的信号是接收到的射频信号经过放大处理得到的，当然信号强声音越大	不能。因为鉴频输出大小只取决于射频信号的频偏，而且正常信号的幅度会被限幅电路切齐到同样大小
LK0788 用设置在NFM方式的对讲机接收WFM信号，其效果为：<br>可以正常听到信号，但声音的高音频部分衰减较大，缺乏高音<br>可以正常听到信号，但声音比较小<br>听不到信号，但接收到信号时调频噪声会变得寂静<br>可以听到信号，但当调制信号幅度较大、音调较高时会发生明显非线性失真	可以听到信号，但当调制信号幅度较大、音调较高时会发生明显非线性失真
LK0789 用设置在WFM方式的对讲机接收NFM信号，其效果为：<br>可以正常听到信号，但声音比较小<br>可以正常听到信号，但声音的高音频部分衰减较大，缺乏高音<br>可以听到信号，但当调制信号幅度较大、音调较高时会发生明显非线性失真<br>听不到信号，但接收到信号时调频噪声会变得寂静	可以正常听到信号，但声音比较小
LK0790 调频接收机没有接收到信号时，会输出强烈的噪声。关于这种噪声的描述是：<br>由天线接收到的背景噪声的随机幅度变化经放大形成，其大小与天线背景噪声电压的平方根成正比<br>由天线接收到的背景噪声的随机幅度变化经放大形成，其大小与天线背景噪声电压的平方成正比<br>由天线背景噪声和机内电路噪声的随机频率变化经鉴频形成，其大小与天线接收到的背景噪声幅度无关<br>由天线接收到的背景噪声的随机幅度变化经放大形成，其大小与天线背景噪声电压成正比	由天线背景噪声和机内电路噪声的随机频率变化经鉴频形成，其大小与天线接收到的背景噪声幅度无关
LK0855 如果业余中继台发射机被断断续续的干扰信号所启动，夹杂着不清楚的语音，根据覆盖区内其他业余电台的监听，确定中继台上行频率并没有电台工作。则：<br>可能是中继台发射机发生了寄生振荡<br>可能是中继台附近的两个其他发射机的强信号在中继台上行频率造成了互调干扰<br>肯定是中继台接收机受到了人为恶意干扰<br>可能是中继台接收机发生了寄生振荡	可能是中继台附近的两个其他发射机的强信号在中继台上行频率造成了互调干扰
LK0898 业余电台在进行业余卫星通信时使用超过常规要求的发射功率，造成的结果以及对这种做法的态度是：<br>上行功率越大，转发的效果越好，通信范围越大；可提倡<br>上行功率超过一定值对通信效果改善不大，但并无明显坏处；无所谓<br>过强的上行信号会使卫星转发器压低对其他信道的转发功率，严重影响别人通信；必须反对<br>上行功率太大造成浪费和电磁污染；不提倡	过强的上行信号会使卫星转发器压低对其他信道的转发功率，严重影响别人通信；必须反对
LK0971 即使在空旷平地，接收到的本地VHF/UHF信号强度也可能会随着接收位置的移动而发生变化，最主要的可能原因是：<br>移动过程中设备与大地之间的分布电容发生微小的变动<br>不同接收位置大地导电率有差异<br>收发位置之间的空气流动造成电波折射不均匀而飘移<br>直射和经地面反射等多条路径到达的电波相位不同，互相叠加或抵消造成衰落（多径效应）	直射和经地面反射等多条路径到达的电波相位不同，互相叠加或抵消造成衰落（多径效应）
LK1065 在相距不远的两点接收同一个远方信号，信号强度发生很大差别，且差别随两点间距离的增大呈周期性变化。这是因为：<br>地磁影响影响<br>大气扰动影响<br>多径传播，各路径到达的信号相位延迟不同而互相干涉<br>发射机到两接收点传播距离不同造成传播路径衰耗不同	多径传播，各路径到达的信号相位延迟不同而互相干涉
LK1130 收发信机中的静噪控制的目的是什么？<br>在没有信号的情况下，关闭音频输出，使其不会输出噪音。<br>可以进行自动增益控制<br>控制发射机的输出功率<br>使接收机的输出音量调到最大	在没有信号的情况下，关闭音频输出，使其不会输出噪音。
LK1182 如果对方报告你的调频电台发射的信号听起来失真严重、可辨度差，可能的原因是：<br>电台所处的位置不好<br>电台的发射频率不准确<br>三项都可能<br>电台的电源电压不足	三项都可能
LK1237 一些VHF/UHF业余无线电调频手持对讲机或车载台的设置菜单中有“全频偏”和“半频偏”的选择，其表示的意义是：<br>全频偏方式语音信号经过压缩，半频偏方式语音信号只压缩低音频分量<br>分别表示信道间隔为25kHz或者12.5kHz<br>全频偏方式下发射频率的误差比半频偏方式大一倍<br>全频偏方式适用于收发异频的中继台通信，半频偏方式适用于同频对讲通信	分别表示信道间隔为25kHz或者12.5kHz
LK0436 用电压表检查一节干电池两端电压，未使用时测得1.5伏左右，用旧后测得1.2伏左右。正确的说法是：<br>旧干电池的电动势为1.5伏<br>旧干电池的电动势为0<br>旧干电池的电动势为1.2伏<br>旧干电池的电动势为1.35伏	旧干电池的电动势为1.5伏
LK0482 测量一个元件是否短路，应该使用：<br>万用电表的电阻挡<br>万用电表的电流挡<br>万用电表的电压挡<br>频谱分析仪	万用电表的电阻挡
LK0483 大致判断一个干电池是否已经失效，应该使用：<br>万用电表的电阻挡<br>音频信号发生器<br>万用电表的电流挡<br>万用电表的电压挡	万用电表的电压挡
LK0691 通信或家用设备的劣质开关电源会造成对无线电接收机的电磁干扰，其源头主要是：<br>开关电源中整流电路的滤波电容容量不足<br>工频电源变压器漏磁感应<br>开关电路的谐波辐射<br>元器件接点不稳造成火花放电干扰	开关电路的谐波辐射
LK1064 家用微波炉一般的工作频带是：<br>UHF（特高频）<br>EHF（极高频）<br>SHF（超高频）<br>VHF（甚高频）	UHF（特高频）
LK1122 下列哪种设备可以用来代替普通的扬声器，可在嘈杂的环境中更好地抄收语音信号？<br>耳机<br>吊杆话筒<br>视频显示器<br>低通滤波器	耳机
LK1137 移动车载电台通常使用的电源电压是？<br>约120伏特<br>约12伏特<br>约30伏特<br>约240伏特	约12伏特
LK1151 下列哪一项可以在电路电流严重过载时保护电路不受损坏？<br>熔断器<br>电容<br>电感<br>屏蔽层	熔断器
LK1153 一个新的干电池的标称电压是多少？<br>1.2伏<br>1.5伏<br>2.2伏<br>1.0伏	1.5伏
LK1154 下列哪一种电池不能充电？<br>铅酸电池<br>碱性电池<br>镍镉电池<br>锂离子电池	碱性电池
LK1162 LED是什么的缩写？<br>阴极射线管<br>场效应管<br>发光二极管<br>液晶显示	发光二极管
LK1163 LCD是什么的缩写？<br>场效应管<br>阴极射线管<br>液晶显示器<br>发光二极管	液晶显示器
LK1167 下列哪一项设备可以把交变电流变成变化的直流？<br>整流器<br>变压器<br>放大器<br>反射器	整流器
LK1169 下列部件中经常被用来把220伏的市电转换成更低电压交流电的是：<br>晶体管<br>二极管<br>变压器<br>可变电容器	变压器
LK1170 下列器件中能够当做指示灯使用的是：<br>LED<br>FET<br>双极型晶体管<br>齐纳二极管	LED
LK1192 如何把一个电压表正确地连接至电路？<br>与电路同相连接<br>并联至电路中<br>串联至电路中<br>正交至电路中	并联至电路中
LK1193 电流表通常要怎样连接至电路？<br>与电路同相连接<br>正交至电路中<br>并联至电路中<br>串联至电路中	串联至电路中
LK1194 哪一种设备被用来测量电阻？<br>示波器<br>频谱分析仪<br>欧姆表<br>天线分析仪	欧姆表
LK1195 下列哪一种行为有可能损坏万用表？<br>在电阻挡试图测量电压<br>把万用表设在“毫安”挡放置了一夜<br>没有让待测量设备适当地预热<br>在大电压量程下测量一个非常小的电压	在电阻挡试图测量电压
LK1196 我们经常使用万用表测量以下哪些物理量？<br>信号的强度和噪音<br>电压和电阻<br>阻抗和电抗<br>驻波比和射频功率	电压和电阻
LK1206 下列哪一种方法可以用来定位无线电噪音源或者恶意干扰源？<br>无线电测向<br>相位锁定<br>多普勒雷达<br>回波定位	无线电测向
LK1229 如何在电网停电的状况下给一个12伏的铅酸蓄电池充电？<br>将蓄电池连接与汽车的蓄电池并联，并且发动汽车<br>将蓄电池放在冰里冷却一会儿<br>将蓄电池串联一个电灯泡作为限流装置，然后连接到220伏市电上<br>给蓄电池中加一些酸	将蓄电池连接与汽车的蓄电池并联，并且发动汽车
LK1231 如果铅酸蓄电池的充电和放电进行得过快会怎样？<br>电池可能会过热，甚至释放出可燃气体，甚至可能爆炸<br>可能会产生过高的充电电压，引起触电的危险<br>电压会将为负值<br>“记忆效应”将使电池的可用容量减小	电池可能会过热，甚至释放出可燃气体，甚至可能爆炸
LK1235 VHF和UHF信号属于下面哪一类辐射？<br>阿尔法辐射<br>非电离辐射<br>电离辐射<br>伽玛辐射	非电离辐射
LK0996 防雷装置的作用是防止雷电危害。传统防雷装置的主要组成部分是：<br>避雷针、过压保护器、熔丝<br>避雷针、高压指示灯、过流保护器<br>天线、限流器、地线<br>接闪器（避雷针）、引下线、接地体	接闪器（避雷针）、引下线、接地体
LK0997 防雷接地的作用是：<br>当接闪器引入雷击电流时迅速烧断熔丝，阻断其流动<br>有效地阻断接闪器引入的雷击电流使其不致流入大地<br>把接闪器引入的雷击电流有效地泄入大地<br>用接闪器感应到的雷电高压启动过压保护电路	把接闪器引入的雷击电流有效地泄入大地
LK0998 关于对防雷接地基本要求的正确说法：<br>要有单独的接地体，接地电阻要小，接闪器到接地体之间的引下线应尽量短而粗<br>交流电网的“零线”在配电系统中已经接地，因此可代替防雷接地体及其引下线<br>接闪器到接地体之间的引下线平时没有电流流过，采用直径0.5毫米的导线为好<br>可以利用与埋地金属管线相连的自来水管作为接地体	要有单独的接地体，接地电阻要小，接闪器到接地体之间的引下线应尽量短而粗
LK0999 单支避雷针的保护范围大致有多大：<br>以避雷针为顶点的45度圆锥体以内空间<br>避雷针周围水平方圆30米内的任何物体<br>以避雷针为顶点、避雷针高度为半径的半球体以内空间<br>避雷针周围所有比避雷针低的空间	以避雷针为顶点的45度圆锥体以内空间
LK1000 安全电压是指不致使人直接致死或致残的电压。标准国家标准GB3805－83《安全电压》，一般环境条件下允许持续接触的“安全特低电压”为：<br>6V<br>48V<br>24V<br>72V	24V
LK1001 触及裸露的射频导线时，与触及相同电压的直流或50Hz交流导线相比，对人身安全危险的大致差别为：<br>更容易出现呼吸或心脏麻痹、更易致死<br>致死危险性下降，但皮肤容易灼伤<br>射频电流对人体没有危险<br>触及不同频率、相同电压的导线时，对人体的危害没有差别	致死危险性下降，但皮肤容易灼伤
LK1039 如遇设备、电线或者电源引起失火，正确的处置为：<br>立即切断电源，使用化学泡沫灭火器灭火<br>迅速起身逃离火场<br>立即切断电源，使用二氧化碳灭火器灭火<br>立即切断电源，用水灭火	立即切断电源，使用二氧化碳灭火器灭火
LK1040 必须带电检修由市电供电的无线电设备时，应做到：<br>双脚与地绝缘，单手操作，另一只手通过触摸机壳或水管等途径良好接地<br>只要确保设备外壳与地绝缘，双脚是否与地绝缘、双手是否同时操作都没有关系<br>双脚与地绝缘，单手操作，另一只手不触摸机壳等任何与电路设备有关的金属物品<br>只要设备外壳良好接地，双脚是否与地绝缘、双手是否同时操作都没有关系	双脚与地绝缘，单手操作，另一只手不触摸机壳等任何与电路设备有关的金属物品
LK1043 两手分别接触电压有效值相同但频率不同的电路两端时，对人体生命安全威胁由大到小的排序为：<br>UHF射频交流电、HF射频交流电、工频交流电<br>HF射频交流电、UHF射频交流电、工频交流电<br>工频交流电、HF射频交流电、UHF射频交流电<br>HF射频交流电、工频交流电、UHF射频交流电	工频交流电、HF射频交流电、UHF射频交流电
LK1225 电路中的保险丝起到什么作用？<br>防止电源纹波损害电路<br>过载时切断电路<br>以上三项全部正确<br>限制电流，防止触电	过载时切断电路
LK1226 为什么在需要安装5安培保险丝的地方安装一个20安培的保险丝是不可取的？<br>电源的纹波会显著增大<br>因为20安培的保险丝电流更大，所以它更容易熔断<br>过大的电流可能导致火灾<br>其他三项全部正确	过大的电流可能导致火灾
LK1227 防止设备外壳带电危险的措施包括：<br>其他三项全部正确<br>安装漏电保护断路器<br>将所有的交流供电设备全部连接至一个安全地线<br>所有使用交流供电的设备的电源线都使用带有单独保护地线端的三线插头	其他三项全部正确
LK1228 在为同轴电缆馈线安装避雷器时应当注意什么？<br>将所有避雷器的地线接到同一个金属板上，然后将这个金属板接到室外的接地极<br>在每一个避雷器的接地线上安装开关，以防止射频过载损伤避雷器<br>将每一个避雷器单独引出接地线，并且将它们都连接至电台的地线<br>要在每一个避雷器处两端并联一个开关，以便在使用大功率输出的时候可以将避雷器旁路掉	将所有避雷器的地线接到同一个金属板上，然后将这个金属板接到室外的接地极
LK1230 常规的12伏酸铅蓄电池通常有什么潜在的危险？<br>它会释放臭氧，进而污染大气层<br>有高电压，存在触电的风险<br>长时间不使用可能会引起自燃<br>如果通风不良，有爆炸风险的气体会聚集	如果通风不良，有爆炸风险的气体会聚集
LK1233 设备电源拔掉电源线以后，检修时还有什么安全风险？<br>静电可能损坏接地系统<br>打开电源外壳可能引起保险丝烧断<br>充满高电压的电容器可能造成电击<br>地磁场可能在变压器中激起感应电流导致电源损坏	充满高电压的电容器可能造成电击
LK1234 自制一台由220伏交流供电的设备，推荐采用的安全措施是：<br>在交流供电入口处串联安装一个电感<br>在交流供电入口处并联安装一个电容<br>交流电源入口火线端串联安装保险丝<br>在交流供电入口处并联安装一个交流电压表	交流电源入口火线端串联安装保险丝
LK0574 假设中继台的收、发信机共用天线，上下行频率分别为F1和F2。要防止中继台发射机对接收机产生干扰，应该对中继台设备采取下列措施：<br>在发信机与天线间串联中心频率为F1的带通滤波器，在收信机与天线间串接中心频率为F2的带通滤波器<br>在发信机与天线间串联中心频率为F1的带阻滤波器，在收信机与天线间串接中心频率为F1的带阻滤波器<br>在发信机与天线间串联中心频率为F1的带阻滤波器，在收信机与天线间串接中心频率为F2的带阻滤波器<br>在发信机与天线间串联中心频率为F2的带阻滤波器，在收信机与天线间串接中心频率为F2的带阻滤波器	在发信机与天线间串联中心频率为F1的带阻滤波器，在收信机与天线间串接中心频率为F2的带阻滤波器
LK0575 要防止业余HF发射机的杂散发射干扰天线附近的电话机，应该在电话机和电话线之间之间串联：<br>截止频率约为3kHz的高通滤波器<br>中心频率约为3kHz的带通滤波器<br>截止频率不高于1MHz的低通滤波器<br>截止频率约为3kHz的带阻滤波器	截止频率不高于1MHz的低通滤波器
LK1002 我国业余电台应该遵守的关于电磁辐射污染的具体管理规定文件为： <br>《业余电台管理办法》<br>美国FCC《射频电磁场人员暴露准则的测评方法规》<br>国际非电离辐射防护委员会《限制时变电场和磁场暴露的导则》<br>国家标准GB/T 51391《通信工程建设环境保护技术标准》	国家标准GB/T 51391《通信工程建设环境保护技术标准》
LK1003 按照我国国家标准GB/T 51391《通信工程建设环境保护技术标准》，向没有屏蔽空间发射电磁场可以免于管理的有： <br>所有业余电台<br>发射频率30MHz以下的所有业余电台<br>发射频率30MHz以上的所有业余电台<br>等效辐射功率在0.1-3MHz不大于300W、在3MHz-300GHz不大于100瓦的无线通信设施（设备） 	等效辐射功率在0.1-3MHz不大于300W、在3MHz-300GHz不大于100瓦的无线通信设施（设备） 
LK1009 我国国家标准《电磁环境控制限值》规定公众暴露控制限值中，对环境电磁辐射场强任意连续6分钟内的方均根值要求最严格的频率范围为： <br>30MHz- 3GHz<br>1200MHz-30GHz<br>3MHz- 30MHz<br>300kHz-30MHz	30MHz- 3GHz
LK1128 移动车载台的直流电源负极应当接在哪里？<br>可以连接在汽车的任意的金属部分<br>连接在电池的负极或发动机的接地带<br>连接在固定住电台的挂置架上<br>连接在天线座上	连接在电池的负极或发动机的接地带
LK1236 为什么电磁辐射防护规定国家标准中的照射限值随着频率的变化而不同？<br>较低频率的无线电波相对高频率的无线电波拥有更高的能量<br>较低频率的无线电波不会穿透人体<br>在自然中高频电磁波不常见<br>人体会对某些特定频率的电磁波吸收量更大	人体会对某些特定频率的电磁波吸收量更大