LK0001 我国现行法律体系中专门针对无线电管理的最高法律文件及其立法机关是：<br>中华人民共和国电信条例，国务院<br>中华人民共和国业余无线电台管理办法，工业和信息化部<br>中华人民共和国无线电管理办法，工业和信息化部<br>中华人民共和国无线电管理条例，国务院和中央军委	中华人民共和国无线电管理条例，国务院和中央军委
LK0002 我国现行法律体系中专门针对业余无线电台管理的最高法律文件及其立法机关是：<br>个人业余无线电台管理暂行办法，国家体委和国家无委<br>业余无线电台管理暂行规定，国家体委和国家无委<br>中华人民共和国电信条例，国务院<br>业余无线电台管理办法，工业和信息化部	业余无线电台管理办法，工业和信息化部
LK0003 我国的无线电主管部门是：<br>各级体育管理机构<br>各地电信管理局<br>各地业余无线电协会<br>各级无线电管理机构	各级无线电管理机构
LK0004 我国依法负责对业余无线电台实施监督管理的机构是：<br>国家无线电管理机构和地方无线电管理机构<br>国家体育管理机构和地方体育管理机构<br>国家和地方公安部门<br>在国家或地方民政部门注册的业余无线电协会	国家无线电管理机构和地方无线电管理机构
LK0005 《业余无线电台管理办法》所说的“地方无线电管理机构”指的是：<br>省、自治区、直辖市无线电管理机构<br>地市县（区）及以下各级无线电管理机构<br>地方业余无线电协会或者类似组织机构<br>各地方与无线电设备生产销售和无线电应用有关的行政管理机构	省、自治区、直辖市无线电管理机构
LK0006 合法设置业余电台的必要步骤是：<br>经过业余无线电协会或无线电运动协会同意<br>经过所在单位或居委会批准<br>按《业余无线电台管理办法》的规定办理设置审批手续，并取得业余电台执照<br>加入指定的业余无线电民间组织,并按其章程规定的办法办理申请手续	按《业余无线电台管理办法》的规定办理设置审批手续，并取得业余电台执照
LK0007 我国对无线电管理术语“业余业务”、“卫星业余业务”和“业余无线电台”做出具体定义的法规文件是 <br>中华人民共和国无线电管理条例<br>中华人民共和国电信条例<br>中华人民共和国无线电频率划分规定<br>无线电台执照管理规定	中华人民共和国无线电频率划分规定
LK0008 业余电台的法定用途为：<br>供私家车主或者相应组织作为行车安全保障和途中消遣工具<br>供业余无线电爱好者进行自我训练、相互通信和技术研究<br>供公民在业余时间进行与个人生活事务有关的通信<br>供公民在业余时间进行休闲娱乐	供业余无线电爱好者进行自我训练、相互通信和技术研究
LK0009 业余无线电台供下列人群设置和使用：<br>对用无线电台解决日常通信有实际需求的任何公民、社团和单位<br>业余无线电爱好者，即经正式批准的、对无线电技术有兴趣的人，其兴趣纯系个人爱好而不涉及谋取利润<br>业余无线电爱好者，即任何对无线电技术有兴趣的人<br>对无线电技术不感兴趣，但希望把业余无线电台用于业余消遣的公民	业余无线电爱好者，即经正式批准的、对无线电技术有兴趣的人，其兴趣纯系个人爱好而不涉及谋取利润
LK0010 按照《业余电台管理办法》规定，申请设置使用配备有多台业余无线电发射设备的业余无线电台，应该：<br>视为一个业余电台，指配一个电台呼号，但所有设备均应经过核定并将参数载入电台执照<br>视为一个业余电台，指配一个电台呼号，每个频段选择一台设备加以核定并将参数载入电台执照<br>视为一个业余电台，指配一个电台呼号，其中只需有一台设备加以核定并将参数载入电台执照<br>每台设备视为一个业余电台，各指配一个电台呼号，并都应经过核定并将参数载入电台执照	视为一个业余电台，指配一个电台呼号，但所有设备均应经过核定并将参数载入电台执照
LK0011 国家鼓励和支持业余无线电台开展下列活动：<br>休闲娱乐性交谈<br>作为日常公益活动的通信工具<br>无线电通信技术研究、普及活动以及突发重大自然灾害等紧急情况下的应急通信活动<br>机动车辆行车服务性通信活动	无线电通信技术研究、普及活动以及突发重大自然灾害等紧急情况下的应急通信活动
LK0012 关于业余电台管理的正确说法是：<br>通过法律手段限制业余无线电台的设置<br>业余无线电爱好者的一切行为都受国家法律保护<br>依法设置的业余无线电台受国家法律保护<br>在业余电台与其他业务电台遇到干扰纠纷时无条件优先保护其他业务电台	依法设置的业余无线电台受国家法律保护
LK0013 不同类别业余无线电台的主要区别在于：<br>所用业余无线电台设备的功能和价格<br>允许发射的频率范围和最大发射功率<br>设置和操作人员的业余无线电知识和技术水平<br>所用业余无线电台的天线的高度和长度	允许发射的频率范围和最大发射功率
LK0014 A类业余无线电台允许发射的发射频率为：<br>30-3000MHz范围内的各业余业务和卫星业余业务频段<br>所有VHF和UHF频段<br>各VHF和UHF频段<br>各业余业务和卫星业余业务频段	30-3000MHz范围内的各业余业务和卫星业余业务频段
LK0015 B类业余无线电台允许发射的发射频率为：<br>各VHF和UHF频段<br>限于HF范围内的各业余业务和卫星业余业务频段<br>30-3000MHz范围外的各业余业务和卫星业余业务频段<br>各业余业务和卫星业余业务频段	各业余业务和卫星业余业务频段
LK0016 C类业余无线电台允许发射的频率为：<br>各VHF和UHF频段<br>30-3000MHz范围外的各业余业务和卫星业余业务频段<br>各业余业务和卫星业余业务频段<br>限于HF、VHF、UHF范围内的各业余业务和卫星业余业务频段	各业余业务和卫星业余业务频段
LK0017 A类业余无线电台允许发射的最大发射功率为不大于：<br>25瓦<br>30MHz以下业余频段不大于100瓦，30MHz以上业余频段不大于25瓦<br>30MHz以上业余频段不大于100瓦，30MHz以下业余频段不大于25瓦<br>100瓦	25瓦
LK0018 B类业余无线电台允许发射的最大发射功率为不大于：<br>25瓦<br>100瓦<br>30MHz以下业余频段不大于100瓦，30MHz以上业余频段不大于25瓦<br>30MHz以上业余频段不大于100瓦，30MHz以下业余频段不大于25瓦	30MHz以下业余频段不大于100瓦，30MHz以上业余频段不大于25瓦
LK0019 C类业余无线电台允许发射的最大发射功率为不大于：<br>100瓦<br>30MHz以下业余频段不大于1000瓦，30MHz以上业余频段不大于25瓦<br>25瓦<br>30MHz以上业余频段不大于1000瓦，30MHz以下业余频段不大于25瓦	30MHz以下业余频段不大于1000瓦，30MHz以上业余频段不大于25瓦
LK0020 负责组织A类和B类业余无线电台所需操作技术能力的验证的机构是：<br>地方教育、体育机构及其相关民间组织<br>地方业余无线电协会<br>地方无线电管理机构（或其委托单位）<br>国家无线电管理机构和地方无线电管理机构（或其委托单位）	国家无线电管理机构和地方无线电管理机构（或其委托单位）
LK0021 负责组织C类业余无线电台所需操作技术能力的验证的机构是：<br>地方无线电管理机构<br>国家无线电管理机构和地方无线电管理机构<br>国家无线电管理机构<br>地方业余无线电协会	国家无线电管理机构
LK0022 2013年1月1日以后新获得的各类业余无线电台操作技术能力证明文件是：<br>中国无线电运动协会颁发的“业余无线电台操作证书”<br>中国无线电协会颁发的“业余无线电台操作证书”<br>地方无线电协会或者其他业余无线电民间组织颁发的“业余无线电台操作证书”<br>地方无线电协会或者其他业余无线电民间组织出具的盖有公章的证明信件	中国无线电协会颁发的“业余无线电台操作证书”
LK0023 个人申请设置业余无线电台应当提交的书面材料为：<br>三种表格，身份证的原件、复印件<br>两种表格，身份证和操作证书的原件、复印件<br>本人写的申请书，身份证和操作证书的原件、复印件<br>一种表格，身份证和操作证书的原件、复印件	两种表格，身份证和操作证书的原件、复印件
LK0024 业余无线电台专用无线电发射设备的重要特征是：<br>发射频率必须覆盖所有业余频段<br>发射频率不得超出业余频段<br>必须具有数字对讲方式<br>发射方式必须包含调频	发射频率不得超出业余频段
LK0025 业余无线电发射设备的下列指标必须符合国家的相关规定：<br>频率调制频偏和调制度<br>指配频带和必要带宽<br>频率容限和带外发射<br>频率容限和杂散域发射功率	频率容限和杂散域发射功率
LK0026 个人申请设置具有发信功能的业余无线电台的年龄条件是：<br>年满十八周岁<br>具备《业余无线电台操作证书》者申请设置业余无线电台不受年龄限制<br>年满十六周岁<br>年满十四周岁	年满十八周岁
LK0027 独立操作具有发信功能业余无线电台的年龄条件是：<br>年满十四周岁<br>具备《业余无线电台操作证书》者操作业余无线电台不受年龄限制<br>年满十六周岁<br>年满十八周岁	具备《业余无线电台操作证书》者操作业余无线电台不受年龄限制
LK0028 申请设置下列业余无线电台时应在《业余无线电台设置（变更）申请表》 的“台站种类”选择“特殊”类：<br>移动操作的车载台<br>需要到外地移动操作的手持台<br>用于业余卫星通信的地面业余无线电台<br>中继台、信标台、空间台	中继台、信标台、空间台
LK0029 申请设置信标台、空间台和技术参数需要超出管理办法规定的特殊业余电台的办法为：<br>先按设置一般业余电台的办法申请，然后再到本地无线电管理机构办理变更执照核定内容<br>按照设置一般业余电台的办法申请即可，然后根据需要操作就可以<br>在《业余无线电台设置（变更）申请表》 的“台站种类”选择“特殊”类，由地方无线电管理机构受理和初审后交国家无线电管理机构审批<br>必须由地方业余无线电协会作为申请单位，经本地无线电管理机构办理批准设台	在《业余无线电台设置（变更）申请表》 的“台站种类”选择“特殊”类，由地方无线电管理机构受理和初审后交国家无线电管理机构审批
LK0030 负责受理设置业余无线电台申请的机构为：<br>设台地地方无线电管理机构或其正式委托的代理受理服务机构<br>中国无线电协会<br>国家无线电管理机构<br>任何地方业余无线电民间组织	设台地地方无线电管理机构或其正式委托的代理受理服务机构
LK0031 设置在省、自治区、直辖市范围内通信的业余无线电台，审批机构为：<br>设台地的地方无线电管理机构所委托的其他单位<br>设台地的地方无线电管理机构<br>国家无线电管理机构<br>设台地的地方无线电民间机构	设台地的地方无线电管理机构
LK0032 设置通信范围涉及两个以上的省、自治区、直辖市或者涉及境外的一般业余无线电台，审批机构是下列中：<br>设台地的地方无线电民间组织<br>国家无线电管理机构委托的设台地地方无线电民间组织<br>设台地地方无线电管理机构<br>国家无线电管理机构或其委托的设台地的地方无线电管理机构	国家无线电管理机构或其委托的设台地的地方无线电管理机构
LK0033 按照在省、自治区、直辖市范围内通信所申请设置的业余无线电台，如想要将通信范围扩大至涉及两个以上的省、自治区、直辖市或者涉及境外，或者要到设台地以外进行异地发射操作，须办理下列手续：<br>事先向核发执照的无线电管理机构申请办理变更手续，按相关流程经国家无线电管理机构或其委托的设台地的地方无线电管理机构批准后，换发业余无线电台执照<br>只要不会被发现，可以不申请办理变更手续，悄悄越限操作<br>反正已经有了电台执照，只需向核发执照的无线电管理机构通报变更情况即可，不必申请办理变更和换发执照<br>反正已经有了电台执照，可先扩大操作起来，等执照有效期届满时再申请办理变更手续，换发业余无线电台执照	事先向核发执照的无线电管理机构申请办理变更手续，按相关流程经国家无线电管理机构或其委托的设台地的地方无线电管理机构批准后，换发业余无线电台执照
LK0034 业余中继台的设置和技术参数等应满足下列关键条件：<br>仅需符合设台地的地方无线电管理机构的规划及相关规定<br>符合申请人关于设置中继台的客观需求和技术考虑<br>符合国家以及设台地的地方无线电管理机构的规定<br>符合设台地的地方业余无线电民间组织的规划	符合国家以及设台地的地方无线电管理机构的规定
LK0035 业余中继台必备的技术措施为：<br>尽量提高发射功率，以便压制覆盖区内的其他强信号干扰<br>技术加密措施，防止未经设台人允许的业余无线电台启用中继<br>设热备份系统，保证不间断工作<br>设专人负责监控和管理工作，配备有效的遥控手段，保证造成有害干扰时及时停止发射	设专人负责监控和管理工作，配备有效的遥控手段，保证造成有害干扰时及时停止发射
LK0036 某团体依法设置了一部业余中继台。其正确做法是：<br>向其覆盖区域内的所有业余无线电台提供平等的服务，并将使用业余中继台所需的各项技术参数公开<br>中继台是设台者出资建设和维护的，因此仅供经设置者允许的业余电台使用<br>为保证中继台正常运行，要求覆盖区内所有业余电台缴纳维护成本，否则不准使用<br>中继台是设台者出资建设和维护的，因此仅供本团体成员优先使用，空闲时方供其他业余电台使用	向其覆盖区域内的所有业余无线电台提供平等的服务，并将使用业余中继台所需的各项技术参数公开
LK0037 选择144MHz或430MHz业余模拟调频中继台同频段收发频差的原则是：<br>尽量采用非标准频差以阻止一般业余无线电台占用<br>可以在国家《无线电频率划分规定》所规定业余频率范围内任意选择<br>采用业余无线电标准频差，即144MHz频段600kHz，430MHz频段5MHz<br>采用经常变换频差的办法减少占用度	采用业余无线电标准频差，即144MHz频段600kHz，430MHz频段5MHz
LK0038 业余无线电台使用的发射设备必须符合下列条件：<br>必须具备《无线电发射设备型号核准证》<br>商品设备应当具备《无线电发射设备型号核准证》，自制、改装、拼装设备应通过国家相关技术标准的检测<br>国产商品设备应当具备《无线电发射设备型号核准证》，国外商品设备符合国际流行技术标准即可<br>商品设备应当具备《无线电发射设备型号核准证》，自制、改装、拼装设备不受限制	商品设备应当具备《无线电发射设备型号核准证》，自制、改装、拼装设备应通过国家相关技术标准的检测
LK0039 对业余无线电台专用无线电发射设备进行型号核准的依据为：<br>国家《无线电频率划分规定》中有关无线电发射设备技术指标的规定<br>经国家认证的检测单位所制订的技术标准<br>地方无线电管理机构制订的技术标准<br>国家关于专业无线电通信发射设备的技术标准	国家《无线电频率划分规定》中有关无线电发射设备技术指标的规定
LK0040 业余无线电台专用无线电发射设备的发射频率必须满足的条件是：<br>发射频率可以在业余频段和非业余频段之间选择<br>发射频率包含所有业余业务或者卫星业余业务频段<br>发射频率包含至少一个业余业务或者卫星业余业务频段<br>发射频率不能超越业余业务或者卫星业余业务频段	发射频率不能超越业余业务或者卫星业余业务频段
LK0041 申请设置业余无线电台应当具备的条件有：<br>熟悉无线电管理规定、具备国家规定的操作技术能力、发射设备符合国家技术标准、法律和行政法规规定的其他条件<br>熟悉无线电管理规定、具备国家规定的操作技术能力、发射设备符合国家技术标准、当地无线电管理机构委托的受理机构设置的其他条件<br>加入指定协会、具备当地无线电管理机构规定的操作技术能力、发射设备符合国家技术标准、法律和行政法规规定的其他条件<br>熟悉无线电管理规定、具备当地无线电管理机构委托的考试机构设置的操作技术能力标准、发射设备符合国家技术标准、法律和行政法规规定的其他条件	熟悉无线电管理规定、具备国家规定的操作技术能力、发射设备符合国家技术标准、法律和行政法规规定的其他条件
LK0042 使用业余无线电台应当具备的条件有：<br>使用具有发信功能的业余无线电台的，应当年满十八周岁<br>具备国家或地方无线电管理机构核发的业余无线电台执照<br>熟悉无线电管理规定、实际上具备国家规定的操作技术能力但不必需取得相应的证明<br>熟悉无线电管理规定、具备国家规定的操作技术能力并取得相应操作技术能力证明	熟悉无线电管理规定、具备国家规定的操作技术能力并取得相应操作技术能力证明
LK0043 申请设置和使用业余无线电台的条件所规定的“具备国家规定的操作技术能力”，其标志为：<br>取得相应操作技术能力证明，即地方业余无线电协会所颁发的业余无线电台操作证书<br>取得相应操作技术能力证明，即中国无线电协会颁发的业余无线电台操作证书<br>业余无线电爱好者公认具备国家规定的操作技术能力的人，可以免交相应的操作技术能力证明<br>境外无线电管理机构颁发或者开具的业余无线电台执照或证书也可以作为具备国家规定的操作技术能力的证明	取得相应操作技术能力证明，即中国无线电协会颁发的业余无线电台操作证书
LK0044 业余无线电台执照有效期届满后需要继续使用的，应当在下列期限内向核发执照的无线电管理机构申请办理延续手续：<br>有效期届满三个月之内<br>有效期届满一个月前<br>有效期届满一个月之内<br>有效期届满二十天前	有效期届满一个月前
LK0045 因改进或调整业余发射设备使业余无线电台的技术参数超出其业余无线电台执照所核定的范围时，应当办理下列手续：<br>只需及时向核发执照的无线电管理机构通报变更情况，进行备案即可<br>只要设备型号和产品序列号没有改变，不必申请办理变更手续<br>等执照有效期届满时向核发执照的无线电管理机构申请办理变更手续，换发业余无线电台执照<br>及时向核发执照的无线电管理机构申请办理变更手续，换发业余无线电台执照	及时向核发执照的无线电管理机构申请办理变更手续，换发业余无线电台执照
LK0046 终止使用业余无线电台的，应当向下列机构申请注销执照：<br>受国家无线电管理机构委托的全国性业余无线电民间组织<br>国家无线电管理机构<br>核发业余无线电台执照的无线电管理机构<br>受国家无线电管理机构委托的地方业余无线电民间组织	核发业余无线电台执照的无线电管理机构
LK0047 业余无线电台使用的频率应当符合下述规定：<br>IARU三区“频率规划”<br>一般业余无线电书籍所叙述的频率<br>《中华人民共和国无线电频率划分规定》<br>ITU《无线电规则》第IV节“频率划分表”	《中华人民共和国无线电频率划分规定》
LK0048 业余无线电台在业余业务、卫星业余业务作为次要业务使用的频率或者与其他主要业务共同使用的频率上发射操作时，应当注意：<br>遵守无线电管理机构对该频率的使用规定<br>可以任意使用，但在遇到其他业务电台使用时要主动避让<br>首先守听频率是否已由其他业务电台占用，如听不到，即可按照先来先用的原则放心使用<br>只要遵守了《中华人民共和国无线电频率划分规定》的有关规定即可放心使用	遵守无线电管理机构对该频率的使用规定
LK0049 关于业余频率的使用，正确的叙述是：<br>任何业余无线电台在任何频段都享有平等的频率使用权<br>依法成立的地方业余无线电民间组织的业余电台，在其常用的台网频率上享有比其他个人设置的业余电台优先的使用权<br>业余无线电台在无线电管理机构核准其使用的频段内，享有平等的频率使用权<br>业余无线电台在无线电管理机构核准其使用的频段内，不同类别的业余电台享有不同优先程度的频率使用权	业余无线电台在无线电管理机构核准其使用的频段内，享有平等的频率使用权
LK0050 某俱乐部约定了一个成员业余电台之间交流技术的网络频率，当遇有其他业余电台按通信惯例要求参加通信时，处理原则应为：<br>由俱乐部网络控制台决定是其他业余电台是否可以加入<br>无条件欢迎加入，因为任何核准的业余电台对频率享有平等的频率使用权<br>要求其他业余电台在任何时间都不得使用俱乐部自己约定的专用通信频率<br>要求其他业余电台在俱乐部成员结束网络通信后再使用该频率	无条件欢迎加入，因为任何核准的业余电台对频率享有平等的频率使用权
LK0051 “我不是业余无线电爱好者，申请设置业余电台只是为了行车方便，不需要遵守业余无线电的规范”。这种说法：<br>很难说对错，业余电台的定义可以因人而异<br>有一定道理，只要是遵守规定，业余电台也可以为非业余无线电爱好者所用<br>是错误的，也是不具备“熟悉无线电管理规定”设台条件的表现<br>有一定道理，既然行车通信有需求，法规管理应该迎合个人需求	是错误的，也是不具备“熟悉无线电管理规定”设台条件的表现
LK0052 个人提出设置使用业余无线电台申请，就是表示自己对无线电技术发生了兴趣，确认了自己在有关业余无线电台活动中的身份是：<br>业余无线电爱好者，但可以是正在起步的初学者<br>其他职业人员，但不是业余无线电爱好者<br>旅游爱好者，但不是业余无线电爱好者<br>汽车俱乐部会员，但不是业余无线电爱好者	业余无线电爱好者，但可以是正在起步的初学者
LK0053 关于业余无线电台的应急通信，正确的叙述是：<br>在日常应急通信训练中，业余无线电台可以和地方公益性救援团体的非业余无线电台进行通信<br>在日常应急通信训练中，业余无线电台可以和地方公益性救援团体的非业余无线电台进行通信，但须经当地业余无线电协会同意<br>在日常应急通信训练中，业余无线电台可以和各种非业余无线电台进行通信<br>在突发重大自然灾害等紧急情况下，业余无线电台才可以和非业余无线电台进行规定内容的通信	在突发重大自然灾害等紧急情况下，业余无线电台才可以和非业余无线电台进行规定内容的通信
LK0054 业余无线电台允许与非业余无线电台通信的条件是：<br>在青少年科技教育活动中，仅可与青少年非业余无线电台通信，内容限于与青少年科技教育直接有关的事务<br>在突发重大自然灾害等紧急情况下，内容限于与抢险救灾直接相关的紧急事务或者应急救援相关部门交办的任务<br>在无线电技术研究中，仅可与具备其他业务电台执照的对象通信，内容限于技术实验所需的信号<br>在当地政府或非盈利机构组织的公益活动中，内容限于与公益事务或者相关的活动组织机构交办的任务	在突发重大自然灾害等紧急情况下，内容限于与抢险救灾直接相关的紧急事务或者应急救援相关部门交办的任务
LK0055 关于业余无线电台的应急通信，正确的叙述是：<br>在日常公益性社会活动中，业余无线电台的通信内容可以涉及各种公益机构交办的任务<br>在平时的任何时侯，业余无线电台的通信内容可以涉及任何政府组织和非盈利机构交办的任务<br>平时在专门的应急通信训练活动中，业余无线电台的通信内容可以涉及应急救援相关部门和组织机构交办的任务<br>在突发重大自然灾害等紧急情况下，业余无线电台的通信内容可以涉及应急救援相关部门交办的任务	在突发重大自然灾害等紧急情况下，业余无线电台的通信内容可以涉及应急救援相关部门交办的任务
LK0056 某业余电台操作者听到业余专用频率上出现某种显然出自非业余电台的人为干扰发射，于是按下话筒向该发射者宣传无线电管理法规知识。对这种做法的评论应该是：<br>正确；但需注意态度耐心、用语文明<br>正确；抓机遇宣传法规，应该提倡<br>错误；违反“业余无线电台的通信对象应当限于业余无线电台”规定。<br>正确；但有点条乱，不予提倡	错误；违反“业余无线电台的通信对象应当限于业余无线电台”规定。
LK0057 在业余无线电台中转发广播电台、互联网聊天、电话通话、其他电台的联络信号，这类行为的性质是：<br>正确行为；既然可以联络，不必要限制向话筒送什么内容<br>如果转发的目的是进行技术调试、用转发信号作为测试信号的话，就是正常行为<br>不算错误但也不值得提倡<br>错误行为；违反“业余无线电台的通信对象应当限于业余无线电台”规定，因为通信中产生信息的一方不是通信业余无线电台本身	错误行为；违反“业余无线电台的通信对象应当限于业余无线电台”规定，因为通信中产生信息的一方不是通信业余无线电台本身
LK0058 业余电台在通信中为其他人或者单位、组织转达信息。对这种做法的评论应该是：<br>只要所转达的信息在内容上不违反《业余电台管理办法规》的禁止规定就是合法行为<br>违法行为；违反“业余无线电台的通信对象应当限于业余无线电台”的规定<br>只要所转达的信息是有利于社会的公益信息，就是合法行为<br>只要转达信息是无偿的，就是合法行为	违法行为；违反“业余无线电台的通信对象应当限于业余无线电台”的规定
LK0059 某业余无线电协会在发射操作中向其会员播发公益性通知和技术训练讲座，但未得到相应无线电管理机构的批准。对这种做法的评论应该是：<br>违法行为；违反“未经核发业余无线电台执照的无线电管理机构批准，业余无线电台不得以任何方式进行广播或者发射通播性质的信号”的规定<br>只要所播发的通知或讲座有利于当地业余无线电应急通信训练，不能算违法行为<br>只要所播发的通知或讲座是涉及宣传业余电台管理知识的，不能算违法行为<br>只要所播发的通知或讲座有利于当地业余无线电爱好者技术水平的提高，不能算违法行为	违法行为；违反“未经核发业余无线电台执照的无线电管理机构批准，业余无线电台不得以任何方式进行广播或者发射通播性质的信号”的规定
LK0060 关于业余无线电台在通信过程中使用的语言，正确的做法为：<br>可以使用虽然不是所有火腿通用、但在某些火腿圈子内部有一定可懂度的新编缩略语或暗语<br>语言要创新，可以使用自创的特殊缩略语，虽开始时象是暗语，用多了就会变明语<br>任何时候都应当使用明语及业余无线电领域公认的缩略语和简语<br>可提倡使用稀有语言或方言，尽量使特定通信对象以外的业余无线电台听不懂，以减少他台呼叫和插入的机会	任何时候都应当使用明语及业余无线电领域公认的缩略语和简语
LK0061 业余无线电台实验新的编码、调制方式、数字通信协议或者交换尚未公开格式的数据文件，正确做法是：<br>事先尽可能采取各种办法向信号可能覆盖范围内的业余无线电爱好者公开有关技术细节，并提交给核发其业余无线电台执照的地方无线电管理机构<br>事先尽可能采取各种办法向信号可能覆盖范围内的业余无线电爱好者公开有关技术细节，但不必提交给核发其业余无线电台执照的地方无线电管理机构<br>应事先提交给核发其业余无线电台执照的地方无线电管理机构，但不必向其他业余无线电爱好者公开有关技术细节<br>不必事先公开或者提交给核发其业余无线电台执照的地方无线电管理机构，以后再说	事先尽可能采取各种办法向信号可能覆盖范围内的业余无线电爱好者公开有关技术细节，并提交给核发其业余无线电台执照的地方无线电管理机构
LK0062 由国家无线电管理机构审批的业余无线电台在设台地以外的地点进行异地发射操作时，应该注意：<br>有了电台执照就是万事大吉，不必认真了解和遵守什么具体规定<br>遵守的限制以业余电台执照所核定的各项参数和核发其业余电台执照的地方无线电管理机构的规定为准，与操作所在地的规定无关<br>既要符合业余电台执照所核定的各项参数约束，又要遵守操作所在地的地方无线电管理机构的相关规定<br>遵守的限制以操作所在地的地方无线电管理机构的相关规定为准，与核发电台执照的地方无线电管理机构的规定无关	既要符合业余电台执照所核定的各项参数约束，又要遵守操作所在地的地方无线电管理机构的相关规定
LK0063 具备国家无线电管理机构规定的操作技术能力并具有法律规定有效证明文件、但还没有获准设置自己的业余电台的人是否可以到业余电台进行发射操作？答案是：<br>青少年可以，成人不可以<br>不可以<br>可以。因为自己没有呼号，只能在通信中使用临时自编的呼号，或用姓名代替呼号<br>可以。使用所操作业余电台的呼号，由该业余电台的设台人对操作不妥而造成的有害干负责	可以。使用所操作业余电台的呼号，由该业余电台的设台人对操作不妥而造成的有害干负责
LK0064 尚未考得《业余电台操作证书》的人在接受业余电台培训中实习发射操作应遵守的条件是什么？<br>尚未取得关于具备操作技术能力有效证明文件者如为青少年，可以在集体业余电台独立操作，如为成人则任何情况下都不可以进行发射操作<br>尚未取得关于具备操作技术能力有效证明文件的人任何情况下都不可以进行发射操作<br>只要业余电台设置人或者其技术负责人能确认实际上已经具备操作技术能力，可以独立进行发射操作，并能为其操作不善造成的后果负责，可以独立发射操作<br>必须已接受法规等基础培训、必须由电台负责人现场辅导、必须在执照核定范围以及国家规定的操作权限内、进行短时间体验性发射操作实习	必须已接受法规等基础培训、必须由电台负责人现场辅导、必须在执照核定范围以及国家规定的操作权限内、进行短时间体验性发射操作实习
LK0065 业余无线电台设置人应对其无线电发射设备担负的法定责任为：<br>应当确保其无线电发射设备随最先进型号更新，为其他业余电台树立求新的榜样<br>应当确保其无线电发射设备达到最大发射功率，以克服其他无线电业务的干扰<br>应当确保其无线电发射设备处于正常工作状态，避免对其他无线电业务造成有害干扰<br>应当确保其无线电发射设备经常处于工作状态，以提高业余频率的实际占用度	应当确保其无线电发射设备处于正常工作状态，避免对其他无线电业务造成有害干扰
LK0066 业余无线电爱好者使用业余无线电收信设备应遵守的规定为：<br>只要不造成对其他业务的无线电干扰，接收无线电信号没有限制<br>只要出于个人对信息的兴趣而不涉及赢利，可以接收任何无线电信号<br>不得接收与业余业务和卫星业余业务无关的信号<br>只要不被查出来，可以接收任何无线电信号	不得接收与业余业务和卫星业余业务无关的信号
LK0067 业余无线电爱好者无意接收到非业余业务和卫星业余业务的信息时，应遵守的规则为：<br>既然自己可以收到，别人也一定可以收到，当然可以传播、公布或者利用<br>不得传播、公布<br>只可以在业余无线电台间共享，不得在其他场合公开<br>只可以用非无线电方式在业余无线电爱好者之间交流，不得以无线电方式转发	不得传播、公布
LK0068 业余无线电台是否可以发射从广播电台收到的信号、音像节目的录音，或者故意转送电台周围的声音？<br>可以，因为该类信息没有保密性<br>可以，用于显示自己发射设备的信号质量<br>可以，用于提起其他有业余无线电台操作员精神，防止乏困<br>不可以，不得发送与业余业务和卫星业余业务无关的信号	不可以，不得发送与业余业务和卫星业余业务无关的信号
LK0069 国家对于利用业余无线电台从事发布、传播违反法律或者公共道德的信息的行为的态度是；<br>不可以发布传、播违法信息。但违反公共道德的信息属于水平问题，不鼓励就是了<br>容忍<br>禁止<br>不提倡	禁止
LK0070 出租车安装业余电台并用来传递有关载客的信息，这种行为的性质是：<br>不太好，因为占用了其他业余电台通信的频率<br>只要管理部门不来查处就可以<br>只要不影响其他业余电台的正常通信就可以<br>违法行为，违反了严禁利用业余无线电台从事从事商业或者其他营利活动的规定	违法行为，违反了严禁利用业余无线电台从事从事商业或者其他营利活动的规定
LK0071 利用业余无线电台通信来促销业余无线电产品或者推动与业余无线电活动有关的其他商业性活动，对这类行为的态度应该是：<br>如果设台人或者设台单位本身是以这类经营为生的，应适当理解和容忍<br>不提倡但也不禁止，毕竟有利于业余无线电活动发展<br>只要是业余无线电民间组织是获利方，即使从事商业或其他营利活动，应支持<br>禁止	禁止
LK0072 利用自己的业余电台强信号故意压制其他业余电台的正常通信，或者在业余无线电频率上转播音乐或广播节目，这些行为的性质属于：<br>正常现象，社会上一些人素质就是如此，应该谅解<br>不文明行为，对其他业余电台不够礼貌<br>不妥行为，没有考虑到他人的乐趣<br>违法行为，违反了严禁阻碍其他无线电台通信的规定	违法行为，违反了严禁阻碍其他无线电台通信的规定
LK0073 业余无线电活动是否有序开展，会影响整个社会的无线电通信的安全和有效，使用不当甚至会导致生命财产损失。业余无线电爱好者在这方的法定责任是：<br>有了电台执照，日常一切言行当然可以带到电台通信中，无责任可言<br>业余无线电台设置、使用人应当加强自律<br>个人没有责任，只能依靠业余无线电民间组织充当“协管”<br>个人没有责任，只能依靠管理部门的监督检查和违法查处	业余无线电台设置、使用人应当加强自律
LK0074 业余无线电台设置、使用人应当接受下列机构对业余无线电台及其使用情况的监督检查：<br>国家计量监督部门的监督检查<br>单位或所在居委会、村民委员会、物主委员会的监督检查<br>无线电管理机构或者其委托单位的监督检查<br>业余无线电民间组织的独立监督检查	无线电管理机构或者其委托单位的监督检查
LK0075 法规和国际业余无线电惯例要求业余电台日志记载的必要基本内容是：<br>通信对方姓名、对方所在国家或城市、通信模式、双方信号报告<br>通信时间、通信频率、通信模式、对方呼号、双方信号报告<br>通信时间、通信频率、双方收发信设备和天线、对方台址<br>通信时间、通信模式、对方信号报告、对方台址、对方天气	通信时间、通信频率、通信模式、对方呼号、双方信号报告
LK0076 法规和国际业余无线电惯例要求业余电台日志记载的必要基本内容是：<br>DATE、TIME、MODE、CALL（对方）、QTH（对方）、RST（双方）<br>DATE、TIME、FREQ、MODE、CALL（对方）、RST（双方）<br>CALL（通信对方）、T IME、FREQ、RIG（对方）、RST（双方）、PWR（双方）<br>DATE、FREQ、QTH（对方）、RIG（对方）、RST（双方）、WX（对方）	DATE、TIME、FREQ、MODE、CALL（对方）、RST（双方）
LK0077 《业余无线电台管理办法》规定业余无线电台设置、正确使用业余无线电台呼号的办法规是：<br>业余电台在通信中可以用自造的呼号作为无线电管理机构指配的业余电台呼号的补充，一起作为电台的标识<br>业余电台在和熟悉的通信对象联络、已经从信号特征确认双方业余电台身份时，可以省略呼号的发送<br>业余无线电台应当在每次通信建立及结束时，主动报出本台呼号，在发射过程中至少每十分钟报出本台呼号一次；对于通信对方，也应使用对方电台的呼号加以标识<br>业余电台在通信中可以用姓名、代号、适当的别名或者法规定呼号的部分数字和字母代替完整的业余电台呼号作为电台的标识	业余无线电台应当在每次通信建立及结束时，主动报出本台呼号，在发射过程中至少每十分钟报出本台呼号一次；对于通信对方，也应使用对方电台的呼号加以标识
LK0078 业余无线电台应当在每次通信建立及结束时，主动报出本台呼号，在发射过程中至少每十分钟报出本台呼号一次。这里的“呼号”是指：<br>可以是完整的电台呼号，也可以是完整电台呼号的任何一部分<br>完整的电台呼号，如在设台地以外的地点进行异地发射操作，还应在前面加上字母B、操作地分区号和符号“/”<br>一般指无线电管理机构指配的电台呼号，但也可以是对方能够理解的民间自创呼号、代号、代码等<br>可以是完整的电台呼号，也可以是电台呼号的分区号加后缀	完整的电台呼号，如在设台地以外的地点进行异地发射操作，还应在前面加上字母B、操作地分区号和符号“/”
LK0079 由国家无线电管理机构批准设台的北京火腿的电台呼号为BH1AAA，把电台带到西安去使用，则本台呼号应该为：<br>BH1AAA/9<br>B1/BH9AAA<br>BH1AAA/B9<br>B9/BH1AAA	B9/BH1AAA
LK0080 业余无线电台呼号的指配流程是：<br>无线电管理机构核发业余无线电台执照时，同时指配业余无线电台呼号<br>在向无线电管理机构委托的受理服务机构提交设台申请窗口后，由服务机构指配呼号<br>无线电管理机构核发业余无线电台执照后，由申请人再向其申请指配呼号<br>业余无线电台设台人在提交设台申请的同时提出所要求指配的呼号，经服务机构同意后，报无线电管理机构正式指配	无线电管理机构核发业余无线电台执照时，同时指配业余无线电台呼号
LK0081 业余无线电爱好者对业已指配给自己的电台呼号不满意，是否可以申请另行指配业余无线电台呼号？<br>不可以。核发业余无线电台执照的无线电管理机构已经为申请人指配业余无线电台呼号的，不另行指配其他业余无线电台呼号<br>业余无线电台执照有效期届满、设台人向核发执照的无线电管理机构申请办理延续手续时可以申请另行指配业余无线电台呼号<br>可以申请另行指配业余无线电台呼号，但须缴纳额外的费用<br>更新所设置的业余无线电台类别时可以申请另行指配业余无线电台呼号	不可以。核发业余无线电台执照的无线电管理机构已经为申请人指配业余无线电台呼号的，不另行指配其他业余无线电台呼号
LK0082 各地业余无线电台呼号前缀字母和后缀字符的可用范围的确定方法是：<br>由国家无线电管理机构编制和分配<br>地方无线电民间组织提出建议，当地无线电管理机构批准<br>地方无线电管理机构根据当地呼号资源的使用情况自行分配<br>由业余无线电爱好者根据需求提出建议，当地无线电管理机构批准	由国家无线电管理机构编制和分配
LK0083 业余无线电爱好者是否可要求设台地所在地方无线电管理机构给予指配超出业已分配给该地方的前缀字母和后缀字符可用范围的业余无线电台呼号？<br>不能，特殊业余无线电台呼号只能由国家无线电管理机构指配<br>可以，但只限于当地业余无线电台参加国际重要业余无线电活动的特殊情况<br>可以，但只限于与在当地所举办的大型国际或国家级活动有关的特殊电台<br>可以，但只限于与当地政府组织的大型科技活动有关的特殊电台	不能，特殊业余无线电台呼号只能由国家无线电管理机构指配
LK0084 某业余无线电爱好者，自己所设置的业余无线电台呼号为BH1ZZZ。现该爱好者到业余无线电台BH9YYY做客并在该台进行发射操作。应当使用的呼号为：<br>BH9/BH1ZZZ或者BH1ZZZ<br>BH1ZZZ或者B9/BH1ZZZ<br>BH1ZZZ/9或者BH1ZZZ/BH9<br>BH9YYY或者B9/BH1ZZZ	BH9YYY或者B9/BH1ZZZ
LK0085 某业余无线电爱好者，自己所设置的业余无线电台呼号为BH1ZZZ。现该爱好者到业余无线电台BH1YYY做客并在该台进行发射操作。应当使用的呼号为：<br>BH1ZZZ或者B1/BH1ZZZ<br>BH1ZZZ/1或者BH1ZZZ/BH1<br>BH1/BH1ZZZ<br>BH1ZZZ	BH1ZZZ或者B1/BH1ZZZ
LK0086 某业余无线电爱好者，自己所设置的业余无线电台呼号为BH1ZZZ。现该爱好者将自己的业余无线电台带到湖南进行异地发射操作。应当使用的呼号为：<br>BH1ZZZ/B7<br>B7/BH1ZZZ<br>BH7/BH1ZZZ<br>BH1ZZZ	B7/BH1ZZZ
LK0087 某业余无线电爱好者，自己所设置的业余无线电台呼号为BH1ZZZ。现该爱好者到业余无线电台BH3YYY做客并并在该台进行发射操作。这种发射操作在业余无线电台管理中称为：<br>异地发射操作<br>移动发射操作<br>违章发射操作<br>客席发射操作	客席发射操作
LK0088 某业余无线电爱好者，自己所设置的业余无线电台呼号为BH1ZZZ。现该爱好者将自己的业余无线电台带到广东进行发射操作。这种发射操作在业余无线电台管理中称为：<br>违章发射操作<br>异地发射操作<br>临时发射操作<br>客席发射操作	异地发射操作
LK0089 经地方无线电管理机构批准设置的业余无线电台，设台地迁入其他省、自治区或者直辖市时，应办理的手续为：<br>先到原核发执照的无线电管理机构办理申请注销原业余无线电台，再到迁入地的地方无线电管理机构办理申请设置业余无线电台的手续<br>持原电台执照直接到原核发执照的无线电管理机构申请办理变更手续<br>不需要办理任何手续<br>持原电台执照直接到迁入地的地方无线电管理机构申请办理变更手续	先到原核发执照的无线电管理机构办理申请注销原业余无线电台，再到迁入地的地方无线电管理机构办理申请设置业余无线电台的手续
LK0090 经国家无线电管理机构批准设置的业余无线电台，设台地迁入其他省、自治区或者直辖市时，应办理的手续为：<br>持原电台执照直接到原核发执照的无线电管理机构申请办理变更手续<br>持原电台执照直接到迁入地的地方无线电管理机构申请办理变更手续<br>先到原核发执照的无线电管理机构申请办理注销手续，缴回原电台执照，领取国家无线电管理机构已批准设台的证明，凭证明到迁入地的地方无线电管理机构完成申请变更手续，领取新电台执照<br>不需要办理任何手续	先到原核发执照的无线电管理机构申请办理注销手续，缴回原电台执照，领取国家无线电管理机构已批准设台的证明，凭证明到迁入地的地方无线电管理机构完成申请变更手续，领取新电台执照
LK0091 设台地迁入其他省、自治区或者直辖市时，业余电台呼号的指配方法为：<br>可以在保留原电台呼号的同时申请指配迁入地的新电台呼号<br>由设台人选择：方法一，注销原电台呼号，指配迁入地的新电台呼号；方法二，申请在迁入地继续指配原来的电台呼号<br>必须指配迁入地的新电台呼号<br>必须继续指配原来的电台呼号	由设台人选择：方法一，注销原电台呼号，指配迁入地的新电台呼号；方法二，申请在迁入地继续指配原来的电台呼号
LK0092 设台地迁入其他省、自治区或者直辖市时，申请在迁入地继续指配原来的电台呼号的手续为：<br>先到原核发执照的无线电管理机构申请办理注销手续，缴回原电台执照，取得由迁入地指配原业余无线电台呼号的书面同意，再到迁入地的地方无线电管理机构办理相应的手续、重新指配原电台呼号，领取新的电台执照<br>只需到迁入地的地方无线电管理机构申请申请办理为迁移后的电台继续使用原电台呼号的全部手续<br>只需到原核发执照的无线电管理机构申请申请办理为迁移后的电台继续使用原电台呼号的全部手续<br>不需办理任何手续即可把原电台呼号带到迁入地继续使用	先到原核发执照的无线电管理机构申请办理注销手续，缴回原电台执照，取得由迁入地指配原业余无线电台呼号的书面同意，再到迁入地的地方无线电管理机构办理相应的手续、重新指配原电台呼号，领取新的电台执照
LK0093 BH1ZZZ由北京迁入河北省，并办妥了由河北无线电管理机构指配使用原电台呼号的全部手续，领取了新的业余无线电台执照。该台在日常通信时应使用呼号：<br>固定台址发射操作用BH1ZZZ，移动发射操用B3/BH1ZZZ<br>B3/BH1ZZZ<br>可任选使用呼号B3/BH1ZZZ或者BH1ZZZ<br>BH1ZZZ	B3/BH1ZZZ
LK0094 对擅自设置、使用业余无线电台的单位或个人，国家无线电管理机构或者地方无线电管理机构可以根据其具体情况给予下列处罚：<br>责令停止使用非法设置的电台；情节严重的，可以并处警告、查封或者没收设备<br>责令停止使用非法设置的电台并作出书面检查；情节严重的，可以并处一千元以下的罚款<br>劝告拆除非法设置的电台；情节严重的，可以并处警告、查封或者没收设备<br>警告、查封或者没收设备、没收非法所得；情节严重的，可以并处一千元以上，五千元以下的罚款	警告、查封或者没收设备、没收非法所得；情节严重的，可以并处一千元以上，五千元以下的罚款
LK0095 业余电台干扰无线电业务的，国家无线电管理机构或者地方无线电管理机构可以根据其具体情况给予设置业余无线电台的单位或个人下列处罚：<br>警告、查封或者没收设备、没收非法所得；情节严重的，可以并处一千元以上，五千元以下的罚款<br>责令停止使用非法设置的电台并作出书面检查；情节严重的，可以并处一千元以下的罚款<br>劝告拆除非法设置的电台；情节严重的，可以并处警告、查封或者没收设备<br>责令停止使用非法设置的电台；情节严重的，可以并处警告、查封或者没收设备	警告、查封或者没收设备、没收非法所得；情节严重的，可以并处一千元以上，五千元以下的罚款
LK0096 业余电台随意变更核定项目、发送和接收与业余无线电无关的信号的，国家无线电管理机构或者地方无线电管理机构可以根据其具体情况给予设置业余无线电台的单位或个人下列处罚：<br>警告、查封或者没收设备、没收非法所得；情节严重的，可以并处一千元以上，五千元以下的罚款<br>责令停止使用非法设置的电台并作出书面检查；情节严重的，可以并处一千元以下的罚款<br>劝告拆除非法设置的电台；情节严重的，可以并处警告、查封或者没收设备<br>责令停止使用非法设置的电台；情节严重的，可以并处警告、查封或者没收设备	警告、查封或者没收设备、没收非法所得；情节严重的，可以并处一千元以上，五千元以下的罚款
LK0097 超出核定范围使用频率或者有其他违反频率管理有关规定的行为的，无线电管理机构可以根据其具体情况给予设置业余无线电台的单位或个人下列处罚：<br>责令限期改正，可以处警告或者一千元以上，五千元以下的罚款<br>责令限期改正，可以处警告或者三万元以下的罚款<br>责令限期改正，可以处警告或者一千元以下的罚款<br>责令限期改正，情节严重的，可以并处警告、查封或者没收设备	责令限期改正，可以处警告或者三万元以下的罚款
LK0098 对涂改、仿制、伪造、倒卖、出租、出借业余无线电台执照，或者以其他形式非法转让业余无线电台执照的，无线电管理机构可以给予下列处罚：<br>应当责令限期改正，情节严重的，可以并处警告、查封或者没收设备<br>应当责令限期改正，可以处警告或者三万元以下的罚款<br>应当责令限期改正，可以处警告或者一千元以上，五千元以下的罚款<br>应当责令限期改正，可以处警告或者一千元以下的罚款	应当责令限期改正，可以处警告或者三万元以下的罚款
LK0099 对盗用、出租、出借、转让、私自编制或者违法使用业余无线电台呼号的，无线电管理机构可以给予下列处罚：<br>应当责令限期改正，可以处警告或者一千元以上，五千元以下的罚款<br>应当责令限期改正，可以处警告或者三万元以下的罚款<br>应当责令限期改正，可以处警告或者一千元以下的罚款<br>应当责令限期改正，情节严重的，可以并处警告、查封或者没收设备	应当责令限期改正，可以处警告或者三万元以下的罚款
LK0100 对以不正当手段取得业余无线电台执照的，无线电管理机构可以给予下列处罚：<br>责令限期改正，可以处警告或者一千元以上，五千元以下的罚款<br>责令限期改正，情节严重的，可以并处警告、查封或者没收设备<br>责令限期改正，可以处警告或者三万元以下的罚款<br>责令限期改正，可以处警告或者一千元以下的罚款	责令限期改正，可以处警告或者三万元以下的罚款
LK0101 对向负责监督检查的无线电管理机构隐瞒有关情况、提供虚假材料或者拒绝提供反映其活动情况的真实材料的，无线电管理机构可以给予下列处罚：<br>责令限期改正，可以处警告或者一千元以下的罚款<br>责令限期改正，可以处警告或者一千元以上，五千元以下的罚款<br>责令限期改正，可以处警告或者三万元以下的罚款<br>责令限期改正，情节严重的，可以并处警告、查封或者没收设备	责令限期改正，可以处警告或者三万元以下的罚款
LK0102 对违法使用业余无线电台造成严重后果的，无线电管理机构可以给予下列处罚：<br>应当责令限期改正，可以处警告或者三万元以下的罚款<br>应当责令限期改正，可以处警告或者一千元以下的罚款<br>应当责令限期改正，可以处警告或者一千元以上，五千元以下的罚款<br>应当责令限期改正，情节严重的，可以并处警告、查封或者没收设备	应当责令限期改正，可以处警告或者三万元以下的罚款
LK0103 违反国家规定，擅自设置、使用无线电台（站），或者擅自占用频率，经责令停止使用后拒不停止使用，干扰无线电通信正常进行，造成严重后果的的，可被判犯扰乱无线电通信管理秩序罪，处三年以下有期徒刑、拘役或者管制，并处或者单处罚金。这个规定出自于下列法规律：<br>中华人民共和国无线电管理条例<br>中华人民共和国民法通则<br>中华人民共和国刑法<br>中华人民共和国电信法	中华人民共和国刑法
LK0104 无线电频率的使用必须得到各级无线电管理机构的批准，基本依据是“无线电频谱资源属于国家所有”，出自于下列法律的第二百五十二条： <br>中华人民共和国电信法<br>中华人民共和国宪法<br>中华人民共和国刑法<br>中华人民共和国民法典	中华人民共和国民法典
LK0105 无线电管制是指在下列范围内依法采取的对无线电波的发射、辐射和传播实施的强制性管理：<br>在例行范围和例行时间内<br>在特定范围、所有时间内<br>在特定时间和特定区域内<br>在全国范围、所有时间内	在特定时间和特定区域内
LK0106 无线电管制是指在特定时间和特定区域内，依法采取的下列性质的管理：<br>对无线电发射设备的生产、销售实施的强制性管理<br>对无线电发射设备的生产、销售实施的指导和行业自律性管理<br>对无线电波的发射、辐射实施的指导和行业自律性管理<br>对无线电波的发射、辐射和传播实施的强制性管理	对无线电波的发射、辐射和传播实施的强制性管理
LK0107 在特定时间和特定区域内实施无线电管制时，与业余无线电有关的管理措施包括：<br>限制或者禁止业余无线电台（站）的使用，以及对特定的无线电频率实施技术阻断等<br>限制、但不会禁止业余无线电台（站）的使用<br>依法设置的业余电台不在管制范围之内<br>限制或者禁止业余无线电台设备的生产和销售	限制或者禁止业余无线电台（站）的使用，以及对特定的无线电频率实施技术阻断等
LK0108 决定实施无线电管制的机构为：<br>在地、市、县实施，由地、市、县人民政府决定<br>在单位、居民区实施，由单位上级业务主管机构和区人民政府共同决定<br>在全国范围内或者跨省、自治区、直辖市实施，由国家无线电管理机构决定。在省、自治区、直辖市范围内实施，由相关地方无线电管理机构决定<br>在全国范围内或者跨省、自治区、直辖市实施，由国务院和中央军事委员会决定。在省、自治区、直辖市范围内实施，由省、自治区、直辖市人民政府和相关军区决定	在全国范围内或者跨省、自治区、直辖市实施，由国务院和中央军事委员会决定。在省、自治区、直辖市范围内实施，由省、自治区、直辖市人民政府和相关军区决定
LK0109 违反无线电管制命令和无线电管制指令的，由下列机构依法进行处罚：<br>城管、工商、交通联合执法<br>当地业余无线电协会<br>国家无线电管理机构或者省、自治区、直辖市无线电管理机构；违反治安管理规定者由公安机关处罚<br>所在军区派出的专门机构	国家无线电管理机构或者省、自治区、直辖市无线电管理机构；违反治安管理规定者由公安机关处罚
LK0110 业余电台违反无线电管制命令和无线电管制指令的，可以依法规受到下列处罚：<br> 责令改正；拒不改正的，关闭、查封、暂扣或者拆除相关设备；情节严重的，吊销电台执照；违反治安管理规定的，由公安机关处罚<br> 处警告或者三万元以下的罚款<br> 责令改正；并开除业余无线电协会会籍、罚没无线电通信设备<br> 处警告或者一千元以上，五千元以下的罚款 	 责令改正；拒不改正的，关闭、查封、暂扣或者拆除相关设备；情节严重的，吊销电台执照；违反治安管理规定的，由公安机关处罚
LK0111 无线电业余业务是供业余无线电爱好者作下列用途的无线电通信业务：<br>救灾抢险、车队联络和技术学习<br>娱乐休闲、报告路况和公益服务<br>技术教学、民兵训练和公益通信<br>自我训练、相互通信和技术研究	自我训练、相互通信和技术研究
LK0112 符合业余无线电爱好者基本条件的人群是：<br>对无线电技术有兴趣并经无线电管理机构批准设置使用业余无线电台的人<br>拥有较高无线电技术水平并加入业余无线电协会的人<br>对无线电技术有兴趣并加入业余无线电协会的人<br>任何对无线电技术有兴趣的公民	对无线电技术有兴趣并经无线电管理机构批准设置使用业余无线电台的人
LK0113 在无线电管理中，由国家将某个特定的频带列入频率划分表，规定该频带可在指定的条件下供业余业余业务或者卫星业余业务使用，这个过程称为：<br>授权<br>分配<br>指配<br>划分	划分
LK0114 在无线电管理中，将无线电频率或频道规定由一个或多个部门，在指定的区域内供地面或空间无线电通信业务在指定条件下使用，这个过程称为：<br>划分<br>分配<br>指配<br>授权	分配
LK0115 在无线电管理中，将无线电频率或频道批准给具体的业余无线电台在规定条件下使用，这个过程称为：<br>指配<br>划分<br>授权<br>分配	指配
LK0116 业余电台的无线电发射设备应符国家规定的下列主要技术指标：<br>杂散发射不低于最大允许功率电平、频率漂移不低于频率容限、电源利用效率满足节能要求<br>杂散发射不低于最大允许功率电平、电源电压及频率符合国家电网标准、采用标准天线阻抗<br>工作频率范围足够宽、杂散发射不低于最大允许功率电平、带宽大于允许最低值<br>符合频率容限、符合杂散发射最大允许功率电平	符合频率容限、符合杂散发射最大允许功率电平
LK0117 频率容限是发射设备的重要指标，通常用下述单位来表示：<br>百万分之几（或者赫兹）<br>瓦<br>百分之几（或者兆赫）<br>dB	百万分之几（或者赫兹）
LK0118 杂散域发射功率是发射设备的重要指标，通常用下述单位来表示：<br>绝对功率dBm、低于载波发射功率的分贝值dBc、低于PEP发射功率的相对值dB<br>绝对功率（瓦）<br>百分之几<br>千赫（或者赫芝）	绝对功率dBm、低于载波发射功率的分贝值dBc、低于PEP发射功率的相对值dB
LK0119 必要带宽（necessary bandwidth）是指：对给定的发射类别而言，其恰好足以保证在相应速率及在指定条件下具有所要求质量的信息传输的所需带宽。业余电台单边带话音通信SSB、低速莫尔斯电码通信CW、调频话音通信FM和残余边带业余电视VSB ATV的必要带宽分别是： <br>5MHz、3000Hz、400Hz、12.5kHz<br>3000Hz、400Hz、12.5kHz、5MH以上<br>3000Hz、400Hz、5MHz以上、12.5kHz<br>12.5kHz、5MHz以上、400Hz、2700Hz	3000Hz、400Hz、12.5kHz、5MH以上
LK0120 以CW方式进行速度为25WPM的摩尔斯电码通信，如果考虑传播衰落的影响，必要带宽约为：<br>200Hz <br>2700Hz<br>6.25kHz<br>12.5kHz	200Hz 
LK0121 用单边带方式进行RTTY通信，速度为50波特，频偏为170Hz，必要带宽约为：<br>200Hz<br>450Hz <br>12.5kHz<br>2700Hz	450Hz 
LK0122 用单边带方式进行话音通信，速度为50波特，频偏为70Hz，必要带宽约为：<br>2700Hz<br>200Hz<br>6.25kHz<br>12.5kHz	2700Hz
LK0123 用通常的调频方式进行话音通信，必要带宽约为：<br>200Hz<br>2700Hz<br>12.5kHz<br>6.25kHz	6.25kHz
LK0124 商用业余单边带电台的语音信号通道为300-3000Hz，高音频部分衰减很大。如果希望对设备进行改装，以将信号带宽扩展到30-16000Hz，大大提升信号质量。可行的方案是：<br>放弃该目标，不应超越业务性质所允许的必要带宽最低值<br>将原单边带信道的晶体滤波器更换为带宽更宽的滤波器<br>配用广播级超高音质话筒<br>在话筒电路中增加分段可控音频均衡电路以提升话筒信号的高音分量	放弃该目标，不应超越业务性质所允许的必要带宽最低值
LK0125 辐射（radiation）是指任何源的能量流以无线电波的形式向外发出。正确的说法是：<br>射频电路中电容器内极板间的电场是一种辐射<br>沿电源线窜入接收机的差模干扰是一种辐射<br>射频电路中变压器内磁芯里的磁场是一种辐射<br>闪电产生的电磁波干扰是一种辐射	闪电产生的电磁波干扰是一种辐射
LK0126 发射（emission）是指：由无线电发信电台产生的辐射或辐射产物。正确的说法是：<br>业余电台向周围发送的杂散产物是一种发射<br>医用高频电疗机向周围发送的无线电波能量是一种发射<br>闪电产生的电磁波干扰是一种发射<br>无线电接收机本地振荡器辐射的能量是一种发射	业余电台向周围发送的杂散产物是一种发射
LK0127 发射类别（class of emission）是指用标准符号标示的某发射的一组特性，例如主载波调制方式，调制信号，被发送信息的类型以及其他适用的信号特性。表示CW报的发射类别是：<br>J3E<br>A1A<br>F2B<br>G2B	A1A
LK0128 发射类别（class of emission）是指用标准符号标示的某发射的一组特性，例如主载波调制方式，调制信号，被发送信息的类型以及其他适用的信号特性。表示单边带话的发射类别是：<br>A1A<br>G2B<br>F2B<br>J3E	J3E
LK0129 发射类别（class of emission）是指用标准符号标示的某发射的一组特性，例如主载波调制方式，调制信号，被发送信息的类型以及其他适用的信号特性。表示用单边带话传输的RTTY信号的发射类别是：<br>J3E<br>F2B<br>A1A<br>G2B	F2B
LK0130 发射类别（class of emission）是指用标准符号标示的某发射的一组特性，例如主载波调制方式，调制信号，被发送信息的类型以及其他适用的信号特性。表示用单边带话传输的PSK31信号的发射类别是：<br>A1A<br>G2B<br>F2B<br>J3E	G2B
LK0131 发射类别（class of emission）是指用标准符号标示的某发射的一组特性，例如主载波调制方式，调制信号，被发送信息的类型以及其他适用的信号特性。表示用单边带话传输的SSTV信号的发射类别是：<br>J3E<br>F3E<br>F2B<br>F3F	F3F
LK0132 发射类别（class of emission）是指用标准符号标示的某发射的一组特性，例如主载波调制方式，调制信号，被发送信息的类型以及其他适用的信号特性。表示调频话的发射类别是：<br>F2B<br>J3E<br>F3E<br>F3F	F3E
LK0133 发射类别（class of emission）是指用标准符号标示的某发射的一组特性，例如主载波调制方式，调制信号，被发送信息的类型以及其他适用的信号特性。表示用调频话传输的RTTY信号的发射类别是：<br>F3E<br>F2B<br>F3F<br>J3E	F2B
LK0134 发射类别是指用标准符号标示的某发射的一组特性，例如主载波调制方式，调制信号，被发送信息的类型以及其他适用的信号特性。表示用调频话传输的SSTV信号的发射类别是：<br>J3E<br>F3F<br>F3E<br>F2B	F3F
LK0135 发射类别是指用标准符号标示的某发射的一组特性，例如主载波调制方式，调制信号，被发送信息的类型以及其他适用的信号特性。表示调频ATV信号的发射类别是： <br>F2B<br>F3E<br>J3E<br>F3F	F3F
LK0136 带外发射是指由于调制过程而产生的、刚超出必要带宽的一个或多个频率的发射，但杂散发射除外。如果单边带发射机在发送由两个音频信号组成的双音信号时，产生的三阶互调分量刚超出了必要带宽3kHz。这种分量的发射属于：<br>谐波发射<br>杂散发射<br>带内发射<br>带外发射	带外发射
LK0137 杂散发射是指必要带宽之外的一个或多个频率的发射，其发射电平可降低而不致影响相应信息的传输。一台发射机，工作频率为145.000MHz，但在435.000MHz的频率上也有发射。这种发射属于：<br>带内发射<br>带外发射<br>谐波发射<br>杂散发射	杂散发射
LK0138 无线电干扰中不属于有害干扰的是：<br>一再阻断按规定正常开展的无线电通信业务的干扰<br>符合国家或国际上规定的干扰允许值和共用标准的干扰<br>严重地损害、阻碍按规定正常开展的无线电通信业务的干扰<br>危害无线电导航或其他安全业务的正常运行的干扰	符合国家或国际上规定的干扰允许值和共用标准的干扰
LK0139 业余无线电专用发射设备必须满足的主要技术指标要求包括：<br>频率容限不低于限值，杂散辐射不超过限值，发射频率不超出国家规定的业余频率<br>频率容限和杂散辐射不超过限值，发射频率包括国家规定的业余频率<br>频率容限和杂散辐射不超过限值，发射频率不超出国家规定的业余频率<br>发射功率不低于功率限额，输出阻抗符合工业标准	频率容限和杂散辐射不超过限值，发射频率不超出国家规定的业余频率
LK0140 在频率划分表中，一个频带被标明划分给多种业务时，这些业务被分为下述类别：<br>民用业务和军用业务<br>业余业务和非业余业务<br>安全业务和一般业务<br>主要业务和次要业务	主要业务和次要业务
LK0141 在频率划分表中，当一个频段划分给业余业务或卫星业余业务和多个其他业务，并且业余业务和卫星业余业务作为次要业务时，业余无线电台应该遵循的规则是：<br>容许因设备技术问题对主要业务电台产生短时间有害干扰<br>不得对来自同一业务或其他次要业务电台的有害干扰提出保护要求<br>可要求保护不受来自主要业务电台的有害干扰<br>不得对主要业务电台产生有害干扰	不得对主要业务电台产生有害干扰
LK0142 在频率划分表中，当一个频段划分给业余业务或卫星业余业务和多个其他业务，并且业余业务和卫星业余业务作为次要业务时，业余无线电台遵循的规则是：<br>容许因设备技术问题对主要业务电台产生短时间有害干扰<br>不得对来自主要业务电台的有害干扰提出保护要求<br>可要求保护不受来自主要业务电台的有害干扰<br>不得对来自同一业务或其他次要业务电台的有害干扰提出保护要求	不得对来自主要业务电台的有害干扰提出保护要求
LK0143 在频率划分表中，当一个频段划分给业余业务或卫星业余业务和多个其他业务，并且业余业务和卫星业余业务作为次要业务时，业余无线电台遵循的规则是：<br>可要求保护不受来自同一业务或其他次要业务电台的有害干扰<br>容许因设备技术问题对主要业务电台产生短时间有害干扰<br>不得对来自同一业务或其他次要业务电台的有害干扰提出保护要求<br>可要求保护不受来自主要业务电台的有害干扰	可要求保护不受来自同一业务或其他次要业务电台的有害干扰
LK0144 我国分配给业余业务和卫星业余业务专用的频段有：<br>7MHz、14MHz、21MHz、28MHz、47GHz频段<br>7MHz、14MHz、21MHz、28MHz、144MHz频段<br>7MHz、14MHz、28MHz、144MHz、430MHz频段<br>3.5MHz、14MHz、21MHz、28MHz、10GHz频段	7MHz、14MHz、21MHz、28MHz、47GHz频段
LK0145 我国分配给业余业务和卫星业余业务与其他业务共用、并且业余业务和卫星业余业务作为主要业务之一的30MHz以下频段有：<br>3.5MHz、10.1MHz、14.25MHz、18.068MHz、29.7MHz频段<br>1.8MHz、10.1MHz、14.25MHz、18.068MHz、21.45MHz频段<br>3.5MHz、7MHz、14.25MHz、21MHz、24.89MHz频段<br>1.8MHz、3.5MHz、14.25MHz、18.068MHz、24.89MHz频段	1.8MHz、3.5MHz、14.25MHz、18.068MHz、24.89MHz频段
LK0146 [Q]我国在VHF和UHF范围内分配给业余业务和卫星业余业务与其他业务共用并设业务类别为主要业务与次要业务，以下那些频率分配给业余业务和卫星业余业务与其他业务共用并且业余业务和卫星业余业务作为主要业务： <br>220MHz、430MHz<br>50MHz、144MHz<br>50MHz、430MHz<br>144MHz、430MHz	50MHz、144MHz
LK0147 我国分配给业余业务和卫星业余业务与其他业务共用、并且业余业务和卫星业余业务作为唯一主要业务的频段的个数以及在3GHz以下的该类频段分别为：<br>3个，144-146MHz<br>5个，28-29.7MHz<br>4个，7.0-7.2MHz<br>5个，50-54MHz	3个，144-146MHz
LK0148 我国分配给业余业务和卫星业余业务与其他业务共用、并且业余业务和卫星业余业务作为次要业务的1200MHz以下频段有：<br>10.1MHz、24.89MHz、430MHz<br>3.5MHz、7MHz、50MHz<br>3.5MHz、18.068MHz、144MHz<br>135.7kHz、10.1MHz、430MHz	135.7kHz、10.1MHz、430MHz
LK0149 我国分配给业余业务和卫星业余业务的频率最高的频段及其共用类别是：<br>77.5-78GHz，主要业务<br>248-250GHz，唯一主要业务<br>134-136GHz，唯一主要业务<br>47-47.2GHz，专用业务	248-250GHz，唯一主要业务
LK0150 国际业余无线电界把WARC-76增加分配给业余业务和卫星业余业务的三个HF频段俗称为WARC频段，它们的频率范围是：<br>10.068-10.168MHz、18.1-18.15MHz、24.89-24.99MHz<br>10.1-10.15MHz、18.068-18.168MHz、24.89-24.99MHz<br>10.1-10.15MHz、18.89-18.99MHz、24.068-24.168MHz<br>10.89-10.88MHz、18.1-18.15MHz、24.068-24.168MHz	10.1-10.15MHz、18.068-18.168MHz、24.89-24.99MHz
LK0151 俗称的40米业余波段，其在ITU1、2、3区的频率范围以及业余业务和卫星业余业务的使用状态分别为：<br>7.0-7.3MHz、7.0-7.3MHz、7.0-7.3MHz，专用<br>7.0-7.3MHz、7.0-7.3MHz、7.0-7.2MHz，专用<br>7.0-7.2MHz、7.0-7.3MHz、7.0-7.2MHz，专用<br>7.0-7.1MHz、7.0-7.2MHz、7.0-7.3MHz，专用	7.0-7.2MHz、7.0-7.3MHz、7.0-7.2MHz，专用
LK0152 俗称的160米业余波段的频率范围以及业余业务和卫星业余业务的使用状态分别为：<br>1800-2000kHz，主要业务<br>1900-2000kHz，主要业务<br>1700-1900kHz，专用业务<br>1800-1900kHz，次要业务	1800-2000kHz，主要业务
LK0153 俗称的80米业余波段的频率范围以及业余业务和卫星业余业务的使用状态分别为：<br>3.5-3.9MHz，次要业务<br>3.5-3.6MHz，专用业务<br>3.5-4.0MHz，主要业务<br>3.5-3.9MHz，主要业务	3.5-3.9MHz，主要业务
LK0154 俗称的20米业余波段的频率范围以及业余业务和卫星业余业务的使用状态分别为：<br>14-14.35MHz为专用，14.35-14.45为主要业务<br>14-14.25MHz为专用，14.25-14.35为主要业务<br>14-14.15MHz为专用，14.15-14.25为主要业务<br>14-14.35MHz，专用	14-14.25MHz为专用，14.25-14.35为主要业务
LK0155 俗称的15米业余波段的频率范围以及业余业务和卫星业余业务的使用状态分别为：<br>21-21.45MHz，专用<br>21-21.35MHz，专用<br>21-21.45MHz，主要业务<br>21-21.45MHz，次要业务	21-21.45MHz，专用
LK0156 俗称的10米业余波段的频率范围以及业余业务和卫星业余业务的使用状态分别为：<br>28-29.6MHz，专用<br>28-30MHz，次要业务<br>28-29.7MHz，专用<br>28-29.7MHz，主要业务	28-29.7MHz，专用
LK0157 俗称的6米业余波段的频率范围以及业余业务和卫星业余业务的使用状态分别为：<br>50-52MHz，次要业务<br>50-54MHz，主要业务<br>51-54MHz，专用<br>52-56MHz，次要业务	50-54MHz，主要业务
LK0158 俗称的2米业余波段的频率范围以及我国业余业务和卫星业余业务的使用状态分别为：<br>144-146MHz；专用<br>144-148MHz；次要业务<br>144-148MHz；其中144-146MHz为专用，146-148MHz为次要业务<br>144-148MHz；其中144-146MHz为唯一主要业务，146-148MHz为与其他业务共同作为主要业务	144-148MHz；其中144-146MHz为唯一主要业务，146-148MHz为与其他业务共同作为主要业务
LK0159 俗称的0.7米业余波段的频率范围以及业余业务和卫星业余业务的使用状态分别为：<br>430-440MHz，主要业务<br>430-440MHz，次要业务<br>430-440MHz，专用<br>420-470MHz，次要业务	430-440MHz，次要业务
LK0160 在我国和多数其他国家的频率分配中，业余业务在430-440MHz频段中作为次要业务与其他业务共用。这个频段中我国分配的主要业务是：<br>固定业务<br>水上移动和航空移动<br>无线电定位和航空无线电导航<br>移动业务	无线电定位和航空无线电导航
LK0161 我国和ITU分配给业余业务和卫星业余业务的属于低频（LF）和中频（MF）范围的频段分别为：<br>我国 135.7-137.8kHz；ITU 137.8-138.6kHz和472-479kHz<br>我国和ITU均为472-479kHz<br>我国 135.7-137.8kHz；ITU为 137.8-139.6kHz<br>我国和ITU均为 135.7-137.8kHz	我国 135.7-137.8kHz；ITU 137.8-138.6kHz和472-479kHz
LK0162 短波业余电台应避免在IARU信标工作频率±500Hz的范围内发射电波。这些频率是：<br>7.150MHz、14.110MHz、18.150MHz、21.150MHz、28.150MHz<br>14.100MHz、18.110MHz、21.150MHz、24.930MHz、28.200MHz<br>14.150MHz、18.100MHz、21.200MHz、24.930MHz、28.200MHz<br>7.100MHz、10.070MHz、14.100MHz、21.100MHz、28.200MHz	14.100MHz、18.110MHz、21.150MHz、24.930MHz、28.200MHz
LK0163 不能用于通话的HF业余频段为：<br>18MHz业余频段<br>10MHz业余频段<br>14MHz业余频段<br>1.8MHz业余频段	10MHz业余频段
LK0164 我国短波业余电台在7MHz频段进行LSB通话时可以实际占用的频率为：<br>7.030-7.200MHz<br>7.000-7.200MHz<br>7.023-7.200MHz<br>7.000-7.100MHz	7.030-7.200MHz
LK0165 短波业余电台在14MHz频段进行USB通话时可以实际占用的频率为：<br>14.000-14.250MHz<br>14.100-14.350MHz<br>14.070-14.250MHz<br>14.030-14.350MHz	14.100-14.350MHz
LK0166 短波业余电台在18MHz频段进行USB通话时可以实际占用的频率为：<br>18.068-18.186MHz<br>18.110-18.170MHz<br>18.1005-18.180MHz<br>18.1105-18.168MHz	18.1105-18.168MHz
LK0167 短波业余电台在21MHz频段进行USB通话时可以实际占用的频率为：<br>21.125-21.45MHz，除去21.1495-21.1505<br>21-21.45MHz<br>21-21.35MHz<br>21.125-21.45MHz	21.125-21.45MHz，除去21.1495-21.1505
LK0168 短波业余电台在24MHz频段进行USB通话时可以实际占用的频率为：<br>24.890-24.98MHz<br>24.928-24.988MHz<br>24.9205-24.99MHz<br>24.9305-24.99MHz	24.9305-24.99MHz
LK0169 短波业余电台在29MHz频段进行USB通话时可以实际占用的频率为：<br>28-29.7MHz<br>28.3-29.3MHz<br>28.2-29.6MHz<br>28.250-29.7MHz	28.3-29.3MHz
LK0170 短波业余电台在29MHz频段进行FM通话时可以实际占用的频率为：<br>28.3-29.510MHz z<br>29.51-29.7MHz<br>28-29.7MHz<br>29.3-29.7MHz	29.51-29.7MHz
LK0171 VHF业余无线电台在144MHz频段进行本地联络时应避免占用的频率为：<br>144-144.035MHz和145.8-146MHz<br>144.050-144.053MHz和145.100-145.750MHz<br>144.035-145.8MHz<br>144.035-144.053MHz和145.550-145.750MHz	144-144.035MHz和145.8-146MHz
LK0172 UHF业余无线电台在430MHz频段进行本地联络时应避免占用的频率为：<br>431.9-432.240MHz和435-438MHz<br>430-431.9MHz和432.240-435MHz<br>431-432MHz和438-440MHz<br>430-431.2MHz和435-436MHz	431.9-432.240MHz和435-438MHz
LK0173 分配给业余业务的某频段的频率下限为F1，业余电台实际可以工作的发信频率应为：<br>F1-2×信号下边带的频率宽度<br>F1<br>F1-信号下边带的频率宽度<br>F1+信号下边带的频率宽度	F1+信号下边带的频率宽度
LK0174 分配给业余业务的某频段的频率上限为F2，业余电台实际可以工作的发信频率应为：<br>F2+信号上边带的频率宽度<br>F2-信号上边带的频率宽度<br>F2<br>F2-2×信号上边带的频率宽度	F2-信号上边带的频率宽度
LK0175 业余无线电测向活动所用的隐蔽台属于下列范畴的设备：<br>属于特殊免执照发射设备，不需取得任何行政许可即可任意设置使用<br>不属于无线电管理对象，由体育主管部门或者体育民间组织的默认即可设置使用<br>属于体育或游戏器材，其性能指标不需经过无线电检测部门检测合格<br>属于业余无线电台设备，设置使用须向无线电管理机构提出申请并得到批准	属于业余无线电台设备，设置使用须向无线电管理机构提出申请并得到批准
LK0176 国际业余无线电联盟（IARU）业余无线电测向锦标赛规则要求144MHz测向发射机采用调幅度为70%-80%的A2A调制方式发射8-15WPM的音频摩尔斯电码发射电台标识。该类发射占用带宽不得大于下列数值：<br>12.5kHz<br>100kHz<br>6kHz<br>25kHz	6kHz
LK0177 负责协调国际无线电管理的政府间组织是：<br>国际业余无线电联盟<br>国际电信联盟<br>联合国大会<br>联合国科教文组织	国际电信联盟
LK0178 国际业余无线电联盟支持会员协会在发展业余无线电时把它看成一种：<br>休闲娱乐手段<br>国家资源<br>拉动经济的措施<br>国防后备队伍	国家资源
LK0179 国际业余无线电联盟由下列元素组成：<br>理事会、地区分会、专业委员会<br>理事会、地区组织、个人会员<br>成员协会、理事会、地区组织<br>个人会员、成员协会、理事会、地区组织	成员协会、理事会、地区组织
LK0180 ITU对于5至30MHz短波频率的态度是：（RR 4.11、 4.11）<br>该段频率特别适用于远距离通信，因此不鼓励本地通信使用，从而防止对远距离通信的有害干扰<br>同样鼓励本地和远距离通信尽量使用该段频率，提高这一段频谱的使用率<br>在保证优先满足本地通信的前提下，允许远距离通信适当使用这一段频率<br>鼓励在这些频段建立大功率中继站，以提高本地通信的覆盖效果	该段频率特别适用于远距离通信，因此不鼓励本地通信使用，从而防止对远距离通信的有害干扰
LK0181 国际电联规定的确定发射电台辐射功率的原则为：<br>发射电台只应辐射为保证满意服务所必要的功率<br>发射电台应辐射尽量大的功率以提供尽量好的信号质量<br>VHF/UHF频段发射电台应辐射尽量大的功率，HF频段发射电台应辐射尽量小的功率<br>HF频段发射电台应辐射尽量大的功率，VHF频段发射电台应辐射尽量小的功率	发射电台只应辐射为保证满意服务所必要的功率
LK0182 下述通信不属于电信（telecommunication）范畴：<br>邮政通信<br>无线电通信<br>光通信<br>有线通信	邮政通信
LK0183 关于无线电通信的正确说法：<br>无线电通信包括利用光在内的所有电磁波所进行的各种通信<br>产生无线电波并用其加热属于无线电通信的一种应用<br>利用无线电波进行的符号、信号、文字、图像、声音以外的信息传输不属于无线电通信<br>无线电通信是指利用无线电波进行的符号、信号、文字、图像、声音或其他信息的传输、发射或接收。	无线电通信是指利用无线电波进行的符号、信号、文字、图像、声音或其他信息的传输、发射或接收。
LK0184 关于地面无线电通信（terrestrial radio communication）的正确说法是：<br>水上通信不属于地面无线电通信<br>地面业余电台之间所进行的任何无线电通信都属于地面无线电通信<br>航空通信属于地面无线电通信<br>依靠电离层反射的天波所进行的通信不属于地面无线电通信	航空通信属于地面无线电通信
LK0185 ITU《无线电规则》禁止所有电台发射下列种类的电波：<br>减幅波（阻尼波）<br>调频波<br>调幅波<br>调相波	减幅波（阻尼波）
LK0186 下列情况会产生减幅波辐射：<br>电视机本振泄漏<br>对讲机按键发射<br>医用高频加热器泄漏<br>电路接触点打火	电路接触点打火
LK0187 无线电波是指：<br>频率为3,000GHz以下的在空间传播的电磁波<br>频率为30 Hz至30GHz的在空间传播的电磁波<br>频率为3,000GHz以下的所有电磁波<br>频率为3,000 Hz至3,000 MHz的电磁波	频率为3,000GHz以下的在空间传播的电磁波
LK0188 我国规定允许C类业余电台在30MHz以下使用的最大发射功率为1000瓦。正确理解为：<br>可以在日常联络遇频率上电台太多的情况下用来取得较强的话语权<br>可以在遇到初学者操作不规范时用最大功率插入、加以纠正和指导<br>仅在参加国际竞赛、进行特殊技术试验等必需使用最大功率时才可使用<br>可以在日常联络中使用最大功率以求对方给出更好的信号报告	仅在参加国际竞赛、进行特殊技术试验等必需使用最大功率时才可使用
LK0189 为了便于计算时间，将地球划分为若干个时区，各理论时区的划分方法是：<br>全球划分为24个时区，每个理论时区宽度为经度15度，其边界为东西经度为15的整倍数的子午线<br>全球划分为12个时区，每个理论时区宽度为经度30度，其边界为东西经度为30的整倍数的子午线<br>全球划分为24个时区，每个理论时区宽度为经度15度，本初子午线通过0区的中心<br>全球划分为12个时区，每个理论时区宽度为经度30度，本初子午线通过0区的中心	全球划分为24个时区，每个理论时区宽度为经度15度，本初子午线通过0区的中心
LK0190 为了便于计算时间，将地球划分为若干个时区，各理论时区的命名规则是：<br>本初子午线通过中心的为0区，如向东数则依次称为东1区、东2区…东24区，如向西数则依次称为西1区、西2区…西24区<br>本初子午线通过其中心的为0区，向东依次为东1区、东2区…东12区，向西依次为西1区、西2区…西12区<br>本初子午线通过中心的为0区，向东依次为1区、2区…24区<br>本初子午线通过中心的为0区，向西依次为1区、2区…24区	本初子午线通过其中心的为0区，向东依次为东1区、东2区…东12区，向西依次为西1区、西2区…西12区
LK0191 为了便于计算时间，将地球划分为若干个时区，北京的情况是：<br>北京处于东8区，地方时间比0时区的时间早8小时<br>北京处于西8区，地方时间比0时区的时间晚8小时<br>北京处于东8区，地方时间比0时区的时间晚8小时<br>北京处于西8区，地方时间比0时区的时间早8小时	北京处于东8区，地方时间比0时区的时间早8小时
LK0192 为了便于计算时间，将地球划分为若干个时区，其理论分区为每区宽经度15度。北京、西安和乌鲁木齐实际所属的时区应为：<br>根据所在经度推算，北京、西安、乌鲁木齐分别处于西8区、西7区和西6区<br>世界上实际使用法定分区，北京、西安、乌鲁木齐都属于东8区<br>根据所在经度推算，北京、西安、乌鲁木齐分别处于东8区、东7区和东6区<br>根据所在经度推算，北京、西安、乌鲁木齐分别处于东6区、东7区和东8区	世界上实际使用法定分区，北京、西安、乌鲁木齐都属于东8区
LK0193 已知北京时间，相应的UTC时间应为：<br>北京时间的小时数减8，如小时数小于0，则小时数加24，日期改为前一天。<br>北京时间的小时数减8，如小时数小于0，则小时数加24，日期改为后一天。<br>北京时间的小时数加8，如小时数大于24，则小时数减24，日期改为前一天。<br>北京时间的小时数加8，如小时数大于24，则小时数减24，日期改为后一天。	北京时间的小时数减8，如小时数小于0，则小时数加24，日期改为前一天。
LK0194 已知UTC时间，相应的北京时间应为：<br>北京时间的小时数减8，如小时数小于0，则小时数加24，日期改为后一天。<br>北京时间的小时数减8，如小时数小于0，则小时数加24，日期改为前一天。<br>UTC时间的小时数加8，如小时数大于24，则小时数减24，日期改为后一天。<br>北京时间的小时数加8，如小时数大于24，则小时数减24，日期改为前一天。	UTC时间的小时数加8，如小时数大于24，则小时数减24，日期改为后一天。
LK0195 已知某业余电台处于西N时区（N为0-12间的整数），该台的当地时间应比北京时间：<br>晚8+N小时<br>早8+N小时<br>晚8-N小时<br>早8-N小时	晚8+N小时
LK0196 已知某业余电台处于东N时区（N为0-12间的整数），该台的当地时间应比北京时间：<br>早8-N小时<br>晚8+N小时<br>晚8-N小时<br>早8+N小时	晚8-N小时
LK0197 深空（deep space)是指离地球的距离约等于或大于下列值的空间：<br>10万米<br>200万千米<br>20万千米<br>15000米	200万千米
LK0198 为划分无线电频率，国际电信联盟《无线电规则》进行了如下的区域划分：<br>将世界划分为40个区域，中国位于第24、25区<br>将世界划分为3个区域，中国位于第3区<br>将世界划分为17个区域，中国位于第8区<br>将世界划分为89个区域，中国位于第33、42、43、44、45、50区	将世界划分为3个区域，中国位于第3区
LK0199 在业余无线电通信中，经常用到把全球分为三个区域的分区办法。制定该分区的国际机构及其公布的文件分别为：<br>美国《CQ》杂志，《WAZ奖状规则》<br>美国业余无线电协会ARRL，《业余无线电手册》<br>国际业余无线电协会IARU，《IARU新闻》<br>国际电信联盟ITU，《无线电规则》	国际电信联盟ITU，《无线电规则》
LK0200 ITU的区域划分有一套详细的规则，粗略地描述大体是：<br>南北美洲为一区，欧洲、俄罗斯亚洲部分、蒙古及部分西北亚国家为二区，亚洲（除俄罗斯、蒙古和部分西北亚洲国家）和大洋洲为三区<br>欧洲、俄罗斯亚洲部分、蒙古及部分西北亚国家为一区，亚洲（除俄罗斯、蒙古和部分西北亚洲国家）和大洋洲为二区，南北美洲为三区，<br>南北美洲为一区，亚洲（除俄罗斯、蒙古和部分西北亚洲国家）和大洋洲为二区，欧洲、俄罗斯亚洲部分、蒙古及部分西北亚国家为三区<br>欧洲、俄罗斯亚洲部分、蒙古及部分西北亚国家为一区，南北美洲为二区，亚洲（除俄罗斯、蒙古和部分西北亚洲国家）和大洋洲为三区	欧洲、俄罗斯亚洲部分、蒙古及部分西北亚国家为一区，南北美洲为二区，亚洲（除俄罗斯、蒙古和部分西北亚洲国家）和大洋洲为三区
LK0201 业余无线电通信计算成绩时，经常用到“CQ分区”。制定该分区的民间机构及其公布的文件分别为：<br>美国业余无线电协会ARRL，《业余无线电手册》<br>美国《CQ》杂志，《WAZ奖状规则》<br>国际业余无线电协会ITU，《IARU新闻》<br>英国业余无线电协会RSGB，《无线电通信》杂志	美国《CQ》杂志，《WAZ奖状规则》
LK0202 我国所属的“CQ分区”有：<br>42、43、44<br>23、24<br>42、43、44、50<br>23、24、27	23、24、27
LK0203 我国黄岩岛、东沙岛、钓鱼岛分别属于“CQ分区”的：<br>24、24、25<br>27、27、24<br>44、44、50<br>27、24、24	27、24、24
LK0204 “ITU分区”是IARU的活动计算通信成绩的基础。我国所属的“ITU分区”有：<br>33、42、43、44、50<br>33、42、43、44<br>23、24<br>23、24、27	33、42、43、44、50
LK0205 “ITU分区”是IARU的活动计算通信成绩的基础。我国黄岩岛、东沙岛、钓鱼岛分别属于“ITU分区”的：<br>50、44、44<br>24、24、25<br>44、44、44<br>27、24、24	50、44、44
LK0206 甲偶极天线的增益为6.15dBi，乙偶极天线的增益为1dBd。当两副天线按同样条件架设、用同样功率驱动时、在它们最大发射方向的同一远方地点接收时，两天线产生的信号功率的关系为：<br>甲天线的信号功率为乙天线的6.15倍<br>甲天线的信号功率为乙天线的两倍<br>甲天线的信号功率为乙天线的1/2<br>甲天线的信号功率为乙天线的5.15倍	甲天线的信号功率为乙天线的两倍
LK0207 甲天线的增益为0dBd，乙天线的增益为2dBi。当两副天线按同样条件架设、用同样功率驱动时、在它们最大发射方向的同一远方地点接收并比较收到的信号功率强度，正确的说法为：<br>甲天线的效果与半波长偶极天线相当，乙天线发射的信号强度比甲天线好2dB。<br>甲、乙天线的效果实际相同<br>甲天线的效果与半波长偶极天线相当，乙天线比甲天线略差。<br>甲天线效果为零，不能工作，乙天线效果比甲天线好2倍。	甲天线的效果与半波长偶极天线相当，乙天线比甲天线略差。
LK0208 已知某天线的增益为3.85 dBd，馈入的功率为10W，其等效全向辐射功率（e.i.r.p）为：<br>40W<br>13.85W<br>38.5W<br>100W	40W
LK0209 《中华人民共和国无线电频率划分规定》脚注5.67A 说“使用135.7-137.8kHz频段内频率的业余业务台站，其最大有效辐射功率不得超过1瓦（e.i.r.p.）”。其意思为，该频率的业余电台：<br>发射机标称输出功率不得超过1瓦<br>扣除馈线损耗后实际馈送到发射天线的功率不得超过1瓦<br>扣除馈线和天线的总损耗后天线实际辐射的功率最大不得超过1瓦<br>实际馈送到发射天线的功率不得超过1瓦除以天线的绝对增益比值Gi后得到的功率值	实际馈送到发射天线的功率不得超过1瓦除以天线的绝对增益比值Gi后得到的功率值
LK0210 《中华人民共和国无线电频率划分规定》脚注5.67A 说“使用135.7-137.8kHz频段内频率的业余业务台站，其最大辐射功率不得超过1瓦（e.i.r.p.）”。其意思为，该频率的业余电台：<br>实际馈送到发射天线的功率不得超过1瓦除以天线的绝对增益比值Gi后得到的功率值<br>扣除馈线和天线的总损耗后天线实际辐射的功率最大不得超过1瓦<br>扣除馈线损耗后实际馈送到发射天线的功率不得超过1瓦<br>发射机标称输出功率不得超过1瓦	实际馈送到发射天线的功率不得超过1瓦除以天线的绝对增益比值Gi后得到的功率值
LK0211 已知某天线的增益为5.15 dBi，馈入的功率为10W，其有效辐射功率（e.r.p）为：<br>15.15W<br>51.5W<br>20W<br>10W	20W
LK0212 我国无线电频率划分表划分给业余业务使用的最低频带为135.7-137.8 kHz，属于无线电频谱的下列频带（波段）：<br>甚低频（甚长波）<br>特低频（特长波）<br>低频（长波）<br>超低频（超长波）	低频（长波）
LK0213 我国无线电频率划分表划分给业余业务使用的最低频带为135.7-137.8 kHz，属于无线电频谱的下列频带（波段）：<br>SLF<br>ULF<br>VLF<br>LF	LF
LK0214 我国无线电频率划分表划分给业余业务使用的1,800kHz-2,000kHz属于无线电频谱的下列频带（波段）：<br>中频（中波）<br>甚高频（米波）<br>高频（短波）<br>低频（长波）	中频（中波）
LK0215 我国无线电频率划分表划分给业余业务使用的1,800kHz-2,000kHz属于无线电频谱的下列频带（波段）：<br>HF<br>VHF<br>MF<br>LF	MF
LK0216 我国无线电频率划分表划分给业余业务使用的28MHz-29.7MHz属于无线电频谱的下列频带（波段）：<br>甚高频（米波）<br>中频（中波）<br>低频（长波）<br>高频（短波）	高频（短波）
LK0217 我国无线电频率划分表划分给业余业务使用的28MHz-29.7MHz属于无线电频谱的下列频带（波段）：<br>MF<br>VHF<br>LF<br>HF	HF
LK0218 我国无线电频率划分表划分给业余业务使用的50MHz-54MHz属于无线电频谱的下列频带（波段）：<br>高频（短波）<br>特高频（分米波）<br>甚高频（米波）<br>超高频（厘米波）	甚高频（米波）
LK0219 我国无线电频率划分表划分给业余业务使用的50MHz-54MHz属于无线电频谱的下列频带（波段）：<br>SHF<br>UHF<br>VHF<br>HF	VHF
LK0220 我国无线电频率划分表划分给业余业务使用的最接近无线宽带WiFi频率的频带为2,300-2,450MHz，属于无线电频谱的下列频带（波段）：<br>高频（短波）<br>超高频（厘米波）<br>特高频（分米波）<br>甚高频（米波）	特高频（分米波）
LK0221 我国无线电频率划分表划分给业余业务使用的最接近无线宽带WiFi频率的频带为2,300-2,450MHz，属于无线电频谱的下列频带（波段）：<br>SHF<br>UHF<br>VHF<br>HF	UHF
LK0222 我国无线电频率划分表划分给业余业务使用的最接近C波段卫星电视广播频率的频带是5.650-5.850GHz，属于无线电频谱的下列频带（波段）：<br>特高频（分米波）<br>超高频（厘米波）<br>甚高频（米波）<br>极高频（毫米波）	超高频（厘米波）
LK0223 我国无线电频率划分表划分给业余业务使用的最接近C波段卫星电视广播频率的频带是5.650-5.850GHz，属于无线电频谱的下列频带（波段）：<br>SHF<br>EHF<br>VHF<br>UHF	SHF
LK0224 我国无线电频率划分表划分给业余业务使用的最接近Ku波段卫星电视广播频率的频带10-10.5GHz，属于无线电频谱的下列频带（波段）：<br>超高频（厘米波）<br>极高频（毫米波）<br>特高频（分米波）<br>甚高频（米波）	超高频（厘米波）
LK0225 我国无线电频率划分表划分给业余业务使用的最接近Ku波段卫星电视广播频率的频带10-10.5GHz，属于无线电频谱的下列频带（波段）：<br>SHF<br>VHF<br>EHF<br>UHF	SHF
LK0226 我国无线电频率划分表划分给业余业务使用的最高频带为241GHz-250GHz，属于无线电频谱的下列频带（波段）：<br>特高频（分米波）<br>极高频（毫米波）<br>超高频（厘米波）<br>至高频（丝米波或亚毫米波）	极高频（毫米波）
LK0227 我国无线电频率划分表划分给业余业务使用的最高频带为241GHz-250GHz，属于无线电频谱的下列频带（波段）：<br>EHF<br>SHF<br>THF<br>UHF	EHF
LK0228 电磁波在电能和磁能相互交换和贮存的过程中向四周传播。影响电磁波辐射场能量的因素有：<br>产生磁场的电流的大小越大，向四周传播的辐射场能量越多，与工作频率无关<br>工作频率越低、产生磁场的电流的大小越大，向四周传播的辐射场能量越多<br>工作频率越高、产生磁场的电流的大小越大，向四周传播的辐射场能量越多<br>工作频率与产生磁场的电流的比值越大，向四周传播的辐射场能量越多	工作频率越高、产生磁场的电流的大小越大，向四周传播的辐射场能量越多
LK0229 业余电台通信中常用到缩写“SASE”，其意义是：<br>请尽快寄出QSL卡片<br>请勿通过卡片管理局交换QSL卡<br>国际邮资券<br>写好收信人地址的信封	写好收信人地址的信封
LK0230 无线电通信一般不推荐用调频话方式传输莫尔斯电码，这是因为：<br>调频话方式传输莫尔斯电码可靠性差<br>调频话方式传输莫尔斯电码时速度受限制<br>调频话方式不能传输莫尔斯电码<br>调频话信道带宽超过传输莫尔斯电码的必要带宽，不符合我国《无线电频率划分规定》“电台的技术特性”章关于 “把带宽保持在技术状态和该项业务的性质所允许的最低值上”的要求	调频话信道带宽超过传输莫尔斯电码的必要带宽，不符合我国《无线电频率划分规定》“电台的技术特性”章关于 “把带宽保持在技术状态和该项业务的性质所允许的最低值上”的要求
LK0231 为了满足我国《无线电频率划分规定》“电台的技术特性”关于无线电通信“把带宽保持在技术状态和该项业务的性质所允许的最低值上”的要求，业余电台操作者应了解各种通信方式的必要带宽。决定必要带宽的因素是：<br>通信距离越近，必要带宽越宽<br>接收设备的灵敏度越高，必要带宽越宽<br>所要传输的信息速率越高、整个通信系统的噪声干扰越大，必要带宽越宽<br>发射设备的功率越大，必要带宽越宽	所要传输的信息速率越高、整个通信系统的噪声干扰越大，必要带宽越宽
LK0232 业余电台在发起呼叫前不可缺少的操作步骤是：<br>先用吹话筒、吹口哨等方法发出连续信号检查天线驻波比<br>先用礼貌的语言请其他电台让出频率<br>先守听一段时间，确保没有其他电台正在使用频率<br>检查发射功率是否达到设备的额定输出功率	先守听一段时间，确保没有其他电台正在使用频率
LK0233 业余电台在发射调试信号进行发射功率和天线驻波比等检查时必须注意做到的是：<br>先将频率设置到无人使用的空闲频率、偏离常用的热点频率<br>先将天线的发射方向指向正北<br>话筒离嘴距离在2公分以上，电键按键时间不短于5秒钟<br>先将收发信机的语音压缩功能打开	先将频率设置到无人使用的空闲频率、偏离常用的热点频率
LK0234 单边带业余电台在测试检查天线驻波比需要发射平稳的连续信号。文明的作法是：<br>将电台设为SSB方式，用平稳的气流对话筒吹口哨<br>将电台设为SSB方式，深呼吸后用平稳的气流对话筒发长音“嘻”<br>先将电台设为CW方式按电键，或者设为AM或FM方式按PTT键（不对话筒说话），产生连续载波，测试结束后设回SSB方式<br>将电台设为SSB方式，深呼吸后用平稳的气流对话筒发长音“啊”	先将电台设为CW方式按电键，或者设为AM或FM方式按PTT键（不对话筒说话），产生连续载波，测试结束后设回SSB方式
LK0235 业余电台通过守听，没有听到信号还不足以确认频率空闲，因为有时听不到通信双方中的另一方，贸然呼叫会对已有的通信造成干扰。为避免这种情况，应该：<br>可以先启动呼叫和进行通信，等听到确实有电台先占用频率，再主动让出<br>先询问“有人使用频率吗”？确认没有应答方能发起呼叫<br>可以先启动呼叫和进行通信，只要没有其他电台出来交涉就可放心使用<br>因为守听没有听到别人的信号，可以放心发起呼叫	先询问“有人使用频率吗”？确认没有应答方能发起呼叫
LK0236 业余电台发起呼叫前应先守听一段时间，如没有听到信号，应再询问“有人使用频率吗”？确认没有应答方能发起呼叫。下列英语短句中不能正确表达这一询问的是：<br>Calling you, Roger？<br>Is the frequency in use？<br>Any body here？<br>Is any body in the frequency？	Calling you, Roger？
LK0237 业余电台发起呼叫前应先守听一段时间，如没有听到信号，应再询问“有人使用频率吗”？确认没有应答方能发起呼叫。用CW表达这一询问的方法是：<br>QRZ？<br>QRX？<br>QRL？<br>QRV？	QRL？
LK0238 业余电台BH1ZZZ用话音发起CQ呼叫的正确格式为：<br>CQ、CQ、CQ，CQ、CQ、CQ，CQ、CQ、CQ。BH1ZZZ呼叫。请过来。<br>CQ、CQ、CQ。我是1ZZZ。听到请回答<br>CQ、CQ、CQ。BH1ZZZ呼叫。Bravo Hotel One Zulu Zulu Zulu呼叫，BH1ZZZ呼叫。听到请回答。<br>CQ、CQ、CQ。听到请回答。	CQ、CQ、CQ。BH1ZZZ呼叫。Bravo Hotel One Zulu Zulu Zulu呼叫，BH1ZZZ呼叫。听到请回答。
LK0239 业余电台BH1ZZZ用话音发起CQ呼叫的正确格式为：<br>CQ CQ CQ. Go ahead please.<br>CQ CQ CQ, CQ CQ CQ, CQ CQ CQ. This is BH1ZZZ. Back to you.<br>CQ CQ CQ. This One Zulu Zulu Zulu. Over.<br>CQ CQ CQ.This is BH1ZZZ. Bravo Hotel One Zulu Zulu Zulu, BH1ZZZ is calling. I’m standing by.	CQ CQ CQ.This is BH1ZZZ. Bravo Hotel One Zulu Zulu Zulu, BH1ZZZ is calling. I’m standing by.
LK0240 业余电台BH1ZZZ用CW发起CQ呼叫的正确格式为：<br>CQ CQ CQ. DE 1ZZZ PSE KN<br>CQ CQ CQ DE BH1ZZZ PSE K<br>CQ CQ CQ CQ CQ CQ CQ CQ CQ DE BH1ZZZ PSE K<br>CQ CQ CQ DE BH1ZZZ BH1ZZZ BH1ZZZ PSK K	CQ CQ CQ DE BH1ZZZ BH1ZZZ BH1ZZZ PSK K
LK0241 业余电台BH1ZZZ用话音呼叫BH8YYY的正确格式为：<br>BH8YYY。我是BH1ZZZ，我是BH1ZZZ，我是BH1ZZZ。听到请回答。<br>BH8YYY、BH8YYY、BH8YYY。BH1ZZZ呼叫。Bravo Hotel One Zulu Zulu Zulu，BH1ZZZ呼叫。听到请回答。<br>BH8YYY、BH8YYY、BH8YYY。我是1ZZZ。听到请回答<br>8YYY、8YYY、8YYY。BH1ZZZ呼叫。请过来。	BH8YYY、BH8YYY、BH8YYY。BH1ZZZ呼叫。Bravo Hotel One Zulu Zulu Zulu，BH1ZZZ呼叫。听到请回答。
LK0242 业余电台BH1ZZZ用话音呼叫BH8YYY的正确格式为：<br>Bravo Hotel Eight Yankee Yankee Yankee, Bravo Hotel Eight Yankee Yankee Yankee, Bravo Hotel Eight Yankee Yankee Yankee.This is Bravo Hotel One Zulu Zulu Zulu. Bravo Hotel One Zulu Zulu Zulu, Bravo Hotel One Zulu Zulu Zulu is calling. I’m standing by.<br>BH8YYY, BH8YYY, BH8YYY. This One Zulu Zulu Zulu. Come in please.<br>Bravo Hotel Eight Yankee Yankee Yankee, Bravo Hotel Eight Yankee Yankee Yankee, Bravo Hotel Eight Yankee Yankee Yankee. Go ahead please.<br>8YYY, 8YYY, YYY. This is BH1ZZZ. Over.	Bravo Hotel Eight Yankee Yankee Yankee, Bravo Hotel Eight Yankee Yankee Yankee, Bravo Hotel Eight Yankee Yankee Yankee.This is Bravo Hotel One Zulu Zulu Zulu. Bravo Hotel One Zulu Zulu Zulu, Bravo Hotel One Zulu Zulu Zulu is calling. I’m standing by.
LK0243 业余电台BH1ZZZ用CW呼叫BH8YYY的正确格式为：<br>8YYY 8YYY 8YYY DE BH1ZZZ PSE K<br>BH8YYY BH8YYY BH8YYY DE BH1ZZZ PSE K<br>BH8YYY BH8YYY BH8YYY. DE 1ZZZ PSE KN<br>BH8YYY BH8YYY BH8YYY DE BH1ZZZ BH1ZZZ BH1ZZZ PSK K	BH8YYY BH8YYY BH8YYY DE BH1ZZZ BH1ZZZ BH1ZZZ PSK K
LK0244 BH1ZZZ希望加入两个电台正在通信中的谈话，正确的方法为：<br>短暂发射一次“Break in！”或“插入！”，如对方无反应，应加大功率反复作此发射<br>只要双方都是自己熟悉的业余电台操作员，可直接插入谈话，不必拘泥礼节<br>在双方对话的间隙，短暂发射一次“Break in！”或“插入！”，如得到响应，再说明本台呼号 “BH1ZZZ请求插入”，等对方正式表示邀请后，方能加入<br>在一方正在发射期间，短暂插入一次“Break in”，向正在收听的一方发出插入请求	在双方对话的间隙，短暂发射一次“Break in！”或“插入！”，如得到响应，再说明本台呼号 “BH1ZZZ请求插入”，等对方正式表示邀请后，方能加入
LK0245 以请求插入的方式加入两个电台正在通信中的谈话，应满足的起码条件是：<br>自己的操作技巧不亚于原通信双方<br>自己的信号质量不亚于原通信双方<br>确认自己的加入不会影响原通信双方的乐趣<br>自己拥有比原通信双方更有吸引力的谈话内容	确认自己的加入不会影响原通信双方的乐趣
LK0246 发现有业余电台的发射操作技巧不够规范，但还不至于造成严重的干扰和影响，正确的做法是：<br>立即报告当地业余无线电协会，由其总部电台到频率上进行纠察<br>立即在频率上当面加以指出和纠正<br>通过电话、邮件等方式提出善意的改进建议<br>立即报告无线电管理机构进行干涉	通过电话、邮件等方式提出善意的改进建议
LK0247 业余电台通信受到违法电台或者不明电台的有害干扰。正确的做法是：<br>立即报告无线电管理机构进行干涉<br>在频率上向其宣传无线电管理法，要求其停止干扰<br>用大功率信号对其进行压制<br>不予理睬，收集有关信息并向无线电管理机构举报	不予理睬，收集有关信息并向无线电管理机构举报
LK0248 参加DX网络通信有助于与一些稀有电台建立通信。正确做法是：<br>事前了解网络规则，未经主控台允许不能随意发起呼叫，根据主控台要求进行登录，然后需随时注意主控台的安排，在主控台安排DX电台呼叫自己时及时回答联络<br>当两个电台在网络主控台安排下互联联络时，自己可以通过Break in插入通信<br>DX网络时间内肯定有很多DX电台在守听，利用该频点呼叫CQ定有收获<br>听到DX网络通信后，应抓住机会立即对听到的电台发起呼叫	事前了解网络规则，未经主控台允许不能随意发起呼叫，根据主控台要求进行登录，然后需随时注意主控台的安排，在主控台安排DX电台呼叫自己时及时回答联络
LK0249 接收机设置项目中缩写“NB”和“SQL”的中文简称和作用是：<br>NB为“抑噪”，切除高于平均信号的大幅度突发脉冲噪声；SQL为“静噪”，信噪比达不到一定水平时自动关闭音频输出<br>NB和SQL都是指“抑噪”，收不到有用信号时自动关断背景噪声<br>NB和SQL都是指“静噪”，收不到带有预期的特定控制信号时自动关断音频输出<br>NB和SQL都是指“静噪”，切除高于平均信号的大幅度突发脉冲噪声	NB为“抑噪”，切除高于平均信号的大幅度突发脉冲噪声；SQL为“静噪”，信噪比达不到一定水平时自动关闭音频输出
LK0250 单边带发信机语音压缩的作用是：<br>压缩信号所占用的频谱宽度，提高无线电频谱的利用率<br>压低语音信号的低频分量，提升高频分量，以增加信号的带宽，使高音更加细腻<br>压低较弱语音信号的幅度、提升较强信号的幅度，以增加语音的动态范围和抑扬顿挫感<br>压低较强语音信号的幅度、提升较弱信号的幅度，以改善小幅度语音在接收端的信噪比	压低较强语音信号的幅度、提升较弱信号的幅度，以改善小幅度语音在接收端的信噪比
LK0251 收发信机面板上的符号ALC代表什么功能？<br>发信自动音量控制，对音频输入电平进行检测并反馈控制，以维持其在适当限度之内<br>自动频率控制，对发射频率的漂移进行检测并反馈控制，以维持准确的工作频率<br>自动天线调谐，对天线电路的电压驻波比进行检测并进行自动补偿，以维持最小驻波比<br>发信自动电平控制，对射频输出电平进行检测并反馈控制，以维持其在适当限度之内	发信自动电平控制，对射频输出电平进行检测并反馈控制，以维持其在适当限度之内
LK0252 收发信机面板上的符号AT代表什么功能？<br>自动频率控制，对发射频率的漂移进行检测并反馈控制，以维持准确的工作频率<br>发信自动电平控制，对射频输出电平进行检测并反馈控制，以维持其在适当限度之内<br>自动天线调谐，对天线电路的电压驻波比进行检测并进行自动补偿，以维持最小驻波比<br>发信自动音量控制，对音频输入电平进行检测并反馈控制，以维持其在适当限度之内	自动天线调谐，对天线电路的电压驻波比进行检测并进行自动补偿，以维持最小驻波比
LK0253 收发信机面板上的符号ATT代表什么功能？<br>自动天线调谐，对天线电路的电压驻波比进行检测并进行自动补偿，以维持最小驻波比<br>收信机输入衰减器，在接收大信号时接入，使信号不致过大而使前级电路过载<br>发信自动电平控制，对射频输出电平进行检测并反馈控制，以维持其在适当限度之内<br>发信自动音量控制，对音频输入电平进行检测并反馈控制，以维持其在适当限度之内	收信机输入衰减器，在接收大信号时接入，使信号不致过大而使前级电路过载
LK0254 收发信机面板上的符号AGC代表什么功能？<br>自动天线调谐，对天线电路的电压驻波比进行检测并进行自动补偿，以维持最小驻波比<br>收信机自动增益控制，对中频级信号电平进行检测并反馈控制，防止电路过载<br>收信自动音量控制，对音频输出电平进行检测并反馈控制，以维持其在适当限度之内<br>发信自动电平控制，对射频输出电平进行检测并反馈控制，以维持其在适当限度之内	收信机自动增益控制，对中频级信号电平进行检测并反馈控制，防止电路过载
LK0255 收发信机面板上或设置菜单中的符号VOX代表什么功能？<br>发信自动电平控制，对射频输出电平进行检测并反馈控制，以维持其在适当限度之内<br>发信自动音量控制，对音频输入电平进行检测并反馈控制，以维持其在适当限度之内<br>自动天线调谐，对天线电路的电压驻波比进行检测并进行自动补偿，以维持最小驻波比<br>发信机声控，接入后将根据对话筒有无语音输入的判别自动控制收发转换	发信机声控，接入后将根据对话筒有无语音输入的判别自动控制收发转换
LK0256 收发信机面板上的符号PRE代表什么功能？<br>自动天线调谐，对天线电路的电压驻波比进行检测并进行自动补偿，以维持最小驻波比<br>发信语音压缩，对音频输入电平进行检测并反馈控制，以提升语音包络幅度较小的部分<br>收信机前置放大器，在接收微弱信号时接入（此时某些技术指标可能低于额定值）<br>发信自动电平控制，对射频输出电平进行检测并反馈控制，以维持其在适当限度之内	收信机前置放大器，在接收微弱信号时接入（此时某些技术指标可能低于额定值）
LK0257 收发信机面板上的符号PROC代表什么功能？<br>自动天线调谐，对天线电路的电压驻波比进行检测并进行自动补偿，以维持最小驻波比<br>收信机前置放大器，在接收微弱信号时接入（此时某些技术指标可能低于额定值）<br>发信自动电平控制，对射频输出电平进行检测并反馈控制，以维持其在适当限度之内<br>发信语音压缩，对音频输入电平进行检测并反馈控制，以提升语音包络幅度较小的部分	发信语音压缩，对音频输入电平进行检测并反馈控制，以提升语音包络幅度较小的部分
LK0258 收发信机中的PTT是指什么信号？<br>收信机前置放大器，在接收微弱信号时接入（此时某些技术指标可能低于额定值）<br>发信语音压缩，对音频输入电平进行检测并反馈控制，以提升语音包络幅度较小的部分<br>自动天线调谐，对天线电路的电压驻波比进行检测并进行自动补偿，以维持最小驻波比<br>按键发射，有信号（一般为对地接通）时发射机由等待转为发射	按键发射，有信号（一般为对地接通）时发射机由等待转为发射
LK0259 收发信机面板上或设置菜单中的符号SQL代表什么功能？<br>静噪控制，检测到接收信号低于一定电平时关断音频输出<br>收信机前置放大器，在接收微弱信号时接入（此时某些技术指标可能低于额定值）<br>发信语音压缩，对音频输入电平进行检测并反馈控制，以提升语音包络幅度较小的部分<br>自动天线调谐，对天线电路的电压驻波比进行检测并进行自动补偿，以维持最小驻波比	静噪控制，检测到接收信号低于一定电平时关断音频输出
LK0260 有些调频接收机的参数设置菜单有NFM和WFM两种选择。它们的含义是：<br>NFM为窄带调频方式，适用于信道带宽25kHz/12.5kHz的通信信号；WFM为宽带调频方式，适用于接收信道带宽180kHz左右的广播信号<br>NFM代表数字化语音方式，WFM代表模拟语音方式<br>NFM为单频率守候方式，WFM为双频率守候方式<br>NFM为调频通信本地方式（较低灵敏度），WFM为调频通信远程方式（最高灵敏度）	NFM为窄带调频方式，适用于信道带宽25kHz/12.5kHz的通信信号；WFM为宽带调频方式，适用于接收信道带宽180kHz左右的广播信号
LK0261 某些对讲机具有发送DTMF码的功能。缩写DTMF指的是：<br>自动静噪，即在接收机没有收到信号时自动关闭音频输出<br>数字设备识别码，即在松开PTT按键时自动发送一串代表设备代号的二进制数据<br>双音多频编码，由8个音调频率中的两个频率组合成的控制信号，代表16种状态之一，用于遥控和传输数字等简单字符<br>亚音调静噪，即从67-250.3Hz的38个亚音调频率中选取一个作为选通信号，代表38种状态之一，接收机没有收到特定的选通信号时自动关闭音频输出	双音多频编码，由8个音调频率中的两个频率组合成的控制信号，代表16种状态之一，用于遥控和传输数字等简单字符
LK0262 某些对讲机具有发送CTCSS码的功能。缩写CTCSS指的是：<br>亚音调静噪，即从67-250.3Hz的38个亚音调频率中选取一个作为选通信号，代表38种状态之一，接收机没有收到特定的选通信号时自动关闭音频输出<br>双音多频编码，由8个音调频率中的两个频率组合成的控制信号，代表16种状态之一，用于遥控和传输数字等简单字符<br>自动静噪，即在接收机没有收到信号时自动关闭音频输出<br>数字设备识别码，即在松开PTT按键时自动发送一串代表设备代号的二进制数据	亚音调静噪，即从67-250.3Hz的38个亚音调频率中选取一个作为选通信号，代表38种状态之一，接收机没有收到特定的选通信号时自动关闭音频输出
LK0263 为什么不能在低于1.2GHz的业余频段进行常规的ATV通信？<br>多数话音通信集中在较低频段，易对ATV通信产生严重干扰<br>ATV通信需占5MHz以上带宽，较低业余频段不足以容纳<br>频率越高，ATV传输画面的质量越稳定<br>多数话音通信集中在较低频段，而ATV画面发射时间通常较长，所以要主动避让	ATV通信需占5MHz以上带宽，较低业余频段不足以容纳
LK0264 业余收发信机面饭上RIT的中文名称和代表的意义是：<br>清除信道频率存贮器的所有数据<br>异频收发，接收和发射使用互相独立的频率<br>接收增量调谐，在接收频率的主调谐不变的基础上，对接收频率进行附加微调<br>发射增量调谐，在发射频率的主调谐不变的基础上，对发射频率进行附加微调	接收增量调谐，在接收频率的主调谐不变的基础上，对接收频率进行附加微调
LK0265 业余收发信机面饭上XIT的中文名称和代表的意义是：<br>清除信道频率存贮器的所有数据<br>异频收发，接收和发射使用互相独立的频率<br>发射增量调谐，在发射频率的主调谐不变的基础上，对发射频率进行附加微调<br>接收增量调谐，在接收频率的主调谐不变的基础上，对接收频率进行附加微调	发射增量调谐，在发射频率的主调谐不变的基础上，对发射频率进行附加微调
LK0266 业余收发信机面饭上SPLIT的中文名称和代表的意义是：<br>发射增量调谐，在发射频率的主调谐不变的基础上，对发射频率进行附加微调<br>接收增量调谐，在接收频率的主调谐不变的基础上，对接收频率进行附加微调<br>异频收发，接收和发射使用互相独立的频率<br>清除信道频率存贮器的所有数据	异频收发，接收和发射使用互相独立的频率
LK0267 某业余电台CW信号的片段为“by1cra test up 5”，意思是：<br>该台的呼号为BY1CRA，正在参加竞赛，接收频率从发射频率向上偏移5kHz<br>该台正在试验设备并且呼叫BY1CRA，请对方在高5kHz的频率回答<br>该台的呼号为BY1CRA，正在试验信号为UP5的发射设备<br>该台的呼号为BY1CRA，正在试验信号，并希望呼号前缀为UP5的业余电台回答	该台的呼号为BY1CRA，正在参加竞赛，接收频率从发射频率向上偏移5kHz
LK0268 应该关闭接收机AGC功能的情况是：<br>接收微弱信号时<br>有用强信号中夹杂着微弱干扰<br>有用微弱信号和强干扰同时出现时<br>接收特强信号时	有用微弱信号和强干扰同时出现时
LK0269 应选择较短的接收机AGC时间常数的情况是：<br>接收FM/FSK/PSK等包络幅度恒定的信号<br>接收SSB和AM等正常信号的包络幅度不断变化的信号<br>有用微弱信号和强干扰同时出现时<br>将接收机应用于“比幅度法规”测向时	接收FM/FSK/PSK等包络幅度恒定的信号
LK0270 应选择较长的接收机AGC时间常数的情况是：<br>将接收机应用于“比幅度法规”测向时<br>接收FM/FSK/PSK等包络幅度恒定的信号遇到变化很快的传播衰落时<br>接收SSB和AM等正常信号的包络幅度不断变化的信号<br>有用微弱信号和强干扰同时出现时	接收SSB和AM等正常信号的包络幅度不断变化的信号
LK0271 收听射频/中频增益和音频增益分开控制的通信接收机时，较好的设置方法是：<br>任何情况下都应将射频/中频增益放在中间位置，然后从低到高调整音频增益以得到适当的音量<br>信号特弱时尽量把射频/中频增益开到最大，信号特强时尽量把音频增益开到最大，然后从低到高调整另一个增益以得到适当的音量<br>任何情况下都应将音频增益放在中间位置，然后从低到高调整射频/中频增益以得到适当的音量<br>信号特弱时尽量把音频增益开到最大，信号特强时尽量把射频/中频增益开到最大，然后从低到高调整另一个增益以得到适当的音量	信号特弱时尽量把射频/中频增益开到最大，信号特强时尽量把音频增益开到最大，然后从低到高调整另一个增益以得到适当的音量
LK0272 按照有关规定，144MHz和430MHz频段业余中继台的上下行频差应分别为：<br>5MHz、5MHz<br>2MHz、10MHz<br>7.5MHz、10MHz<br>0.6MHz、5MHz。	0.6MHz、5MHz。
LK0273 如果短波业余电台附近环境有不可避免的强烈噪声源影响接收微弱信号，合理的做法是：<br>尽量只呼叫和回答能听到的电台，必须发起CQ呼叫时应降低功率<br>发起CQ呼叫时应增大功率，以便压倒环境噪声<br>发起正常满功率CQ呼叫，并应尽量调小接收机射频增益<br>发起正常满功率CQ呼叫，并设置好接收机的NB、AGC等功能	尽量只呼叫和回答能听到的电台，必须发起CQ呼叫时应降低功率
LK0274 如果与几十公里以外的某业余电台有很多重要的技术问题和个人情况要交流，应该选用下列通信方式：<br>电话或者互联网<br>利用HF频段业余电台<br>利用当地的业余中继台<br>利用天线足够高的VHF/UHF频段业余电台	电话或者互联网
LK0275 业余中继台的使用原则是：<br>鼓励青少年学生通过中继台交流解题方法和学习心得<br>应使中继台尽量处于接近饱和的忙碌状态，提高使用效率<br>鼓励业余无线电民间组织（协会）通过中继台向当地会员发布通知<br>除必要的短暂通信外，应保持业余中继台具有足够的空闲时间，以便随时响应突发灾害应急呼叫	除必要的短暂通信外，应保持业余中继台具有足够的空闲时间，以便随时响应突发灾害应急呼叫
LK0276 无线电通信一般不用调频话方式传输摩尔斯电码，这是因为：<br>调频话方式传输摩尔斯电码时速度受限制<br>调频话方式不能传输摩尔斯电码<br>调频话方式传输摩尔斯电码可靠性差<br>调频话信道带宽超过传输摩尔斯电码的必要带宽，不符合我国《无线电频率划分规定》“电台的技术特性”章关于 “把带宽保持在技术状态和该项业务的性质所允许的最低值上”的要求	调频话信道带宽超过传输摩尔斯电码的必要带宽，不符合我国《无线电频率划分规定》“电台的技术特性”章关于 “把带宽保持在技术状态和该项业务的性质所允许的最低值上”的要求
LK0277 为了满足我国《无线电频率划分规定》“电台的技术特性”关于无线电通信“把带宽保持在技术状态和该项业务的性质所允许的最低值上”的要求，业余电台操作者应了解各种通信方式的必要带宽。决定必要带宽的因素是：<br> 通信距离越近，必要带宽越宽<br> 传输的信息速率越高、系统的噪声干扰越大，必要带宽越宽<br> 接收设备灵敏度越高，必要带宽越宽<br> 发射设备功率越大，必要带宽越宽	 传输的信息速率越高、系统的噪声干扰越大，必要带宽越宽
LK0278 频移电报技术（frequency-shift telegraphy）是指：电报信号控制载波频率在预定的范围之内变化的调频电报技术。下述业余通信使用的是移频电报技术：<br>RTTY<br>CW<br>PSK31<br>SSTV	RTTY
LK0279 单工操作（simplex operation）是指：在一条电信通路的两个方向上交替进行传输的一种工作方式。下列通信采用单工操作方式：<br>两台由PTT键转换收发状态的业余对讲机之间的通信<br>一台业余中继台与一台由PTT键转换收发状态的业余对讲机之间的通信<br>两台有线电话座机之间的通信<br>两台公众移动电话终端（手机）之间的通信	两台由PTT键转换收发状态的业余对讲机之间的通信
LK0280 双工操作（duplex operation）是指：一条电信通路的两个方向能同时进行传输的工作方式。下列通信采用双工操作方式：<br>两台具有QSK功能的业余CW收发信之间的通信<br>两台由PTT键转换收发状态的业余对讲机之间的通信<br>由一台连续工作的430MHz接收机和一台144MHz发信机组成的地面业余电台与业余卫星之间的通信<br>一台业余中继台与一台由PTT键转换收发状态的业余对讲机之间的通信	由一台连续工作的430MHz接收机和一台144MHz发信机组成的地面业余电台与业余卫星之间的通信
LK0281 半双工操作（semi-duplex operation）是指：电路的一端用单工操作，另一端用双工操作的一种工作方式。下列通信采用半双工操作方式：<br>两台具有QSK功能的业余CW收发信之间的通信<br>两台公众移动电话终端（手机）之间的通信<br>两台由PTT键转换收发状态的业余对讲机之间的通信<br>一台业余中继台与一台由PTT键转换收发状态的业余对讲机之间的通信	一台业余中继台与一台由PTT键转换收发状态的业余对讲机之间的通信
LK0282 在业余无线电中，莫尔斯电码的信号速度经常用WPM作为单位，其计量方法为：<br>每分钟实际拍发的英文字符数即为WPM数<br>每分钟实际拍发的中文字符数即为WPM数<br>每分钟包含的无间隙“点”的个数除以50即为WPM数<br>每分钟包含的无间隙“点”的个数除以60即为WPM数	每分钟包含的无间隙“点”的个数除以50即为WPM数
LK0283 在业余无线电中，莫尔斯电码的信号速度经常用WPM作为单位，其计量方法为：<br>每分钟实际拍发的中文字符数即为WPM数<br>每分钟拍发连续“点”的个数除以60即为WPM数<br>每分钟实际拍发的英文字符数即为WPM数<br>每分钟拍发连续英文单词“PARIS”的个数即为WPM数	每分钟拍发连续英文单词“PARIS”的个数即为WPM数
LK0284 在业余无线电中，计算莫尔斯电码的WPM速度时采用的信号时值标准（以一个“点”信号的时间为比较基准）为，点信号、划信号、字符内点划信号的间隔、字符之间的间隔、单词（组）之间的间隔分别为：<br>1、5、1、5、7<br>1、3、1、3、7<br>1、5、2、3、3<br>1、3、1、3、5	1、3、1、3、7
LK0285 “你和我还有事吗”的业余无线电通信Q简语为：<br>QRU<br>QRL？<br>QRU？<br>QRB？	QRU？
LK0286 “我和你无事了”的业余无线电通信Q简语为：<br>QRU？<br>QRU<br>QRS<br>QRL	QRU
LK0287 “谁在呼叫我”的业余无线电通信Q简语为：<br>QRA？<br>QRZ？<br>QSL？<br>QRZ	QRZ？
LK0288 “要我增加功率吗”的业余无线电通信Q简语为：<br>QSO？<br>QRS？<br>QRO？<br>QRO	QRO？
LK0289 “要我减小功率吗”的业余无线电通信Q简语为：<br>QRP<br>QRP？<br>QRS？<br>QSP？	QRP？
LK0290 “我能直接和×××电台通信”的业余无线电通信Q简语为：<br>QSP　×××<br>QRU　×××<br>QSO　×××<br>QRV　×××	QSO　×××
LK0291 “你能直接和×××电台通信吗”的业余无线电通信Q简语为：<br>QRV　××× ？<br>QRL　××× ？<br>QSO　××× ？<br>QRT　××× ？	QSO　××× ？
LK0292 “我遇到他台干扰”的业余无线电通信Q简语为：<br>QRN<br>QSM<br>QSB？<br>QRM	QRM
LK0293 “你遇到他台干扰吗”的业余无线电通信Q简语为：<br>QSM？<br>QRM？<br>QSD？<br>QSN？	QRM？
LK0294 “我遇到天电干扰”的业余无线电通信Q简语为：<br>QST<br>QRN<br>QRM<br>QSN	QRN
LK0295 “你遇到天电干扰吗”的业余无线电通信Q简语为：<br>QRN？<br>QSM？<br>QSN？<br>QRV？	QRN？
LK0296 “要我加快发送速度吗”的业余无线电通信Q简语为：<br>QRQ？<br>QSQ？<br>QRT？<br>QRS？	QRQ？
LK0297 “请加快发送速度”的业余无线电通信Q简语为：<br>QSQ<br>QRQ<br>QSM<br>QSV	QRQ
LK0298 “要我减慢发送速度吗”的业余无线电通信Q简语为：<br>QRQ？<br>QSQ？<br>QRT？<br>QRS？	QRS？
LK0299 “请减慢发送速度”的业余无线电通信Q简语为：<br>QRS<br>QRO<br>QSV<br>QSM	QRS
LK0300 “你是否已准备好”的业余无线电通信Q简语为：<br>QRV？<br>QRL？<br>QRU？<br>QSV？	QRV？
LK0301 “我已准备好”的业余无线电通信Q简语为：<br>QRV<br>QRU<br>QRL<br>QSV	QRV
LK0302 “要我停止发送吗”的业余无线电通信Q简语为：<br>QSX<br>QRT<br>QST？<br>QRT？	QRT？
LK0303 “请停止发送”的业余无线电通信Q简语为：<br>QST<br>QRV<br>QSB<br>QRT	QRT
LK0304 “我的信号有衰落吗”的业余无线电通信Q简语为：<br>QSD？<br>QRB？<br>QSP？<br>QSB？	QSB？
LK0305 “你的信号有衰落”的业余无线电通信Q简语为：<br>QSP<br>QRE<br>QSX<br>QSB	QSB
LK0306 “我发报的手法有毛病吗”的业余无线电通信Q简语为：<br>QSD？<br>QSB？<br>QRT？<br>QSV？	QSD？
LK0307 “你发报的手法有毛病”的业余无线电通信Q简语为：<br>QRC<br>QSD<br>QSK<br>QSU	QSD
LK0308 “你正忙着吗”的业余无线电通信Q简语为：<br>QSU？<br>QRX？<br>QRU？<br>QRL？	QRL？
LK0309 “我正忙着”的业余无线电通信Q简语为：<br>QSV<br>QRX<br>QRL<br>QRB	QRL
LK0310 “能在你的信号间隙中接收吗（即QSK插入方式）”的业余无线电通信Q简语为：<br>QSK？<br>QRF？<br>QSG？<br>QRJ？	QSK？
LK0311 “我在发射的信号间隙中接收（即QSK插入方式）”的业余无线电通信Q简语为：<br>QRE<br>QRK<br>QSK<br>QSM	QSK
LK0312 “你能给我收据（或QSL卡片）吗”的业余无线电通信Q简语为：<br>QRL？<br>QSA？<br>QSL？<br>QSD？	QSL？
LK0313 “我给你收据（QSL卡片）、我已收妥”的业余无线电通信Q简语为：<br>QRG<br>QSX<br>QSL<br>QRV	QSL
LK0314 “你能传信到×××电台吗”的业余无线电通信Q简语为：<br>QSP ×××？<br>QSX ×××？<br>QRD ×××？<br>QRV ×××？	QSP ×××？
LK0315 “我能传信到×××电台”的业余无线电通信Q简语为：<br>QSH ×××<br>QSP ×××<br>QRP ×××<br>QRL ×××	QSP ×××
LK0316 “你将在nnnn KHz（或MHz）频率守听×××电台吗”的业余无线电通信Q简语为：<br>QSL ××× ON nnnn KHz（或MHz）？<br>QSX ××× ON nnnn KHz（或MHz）？<br>QRV ××× ON nnnn KHz（或MHz）？<br>QRU ××× ON nnnn KHz（或MHz）？	QSX ××× ON nnnn KHz（或MHz）？
LK0317 “我将在nnnn KHz（或MHz）频率守听×××电台”的业余无线电通信Q简语为：<br>QSP ××× ON nnnn KHz（或MHz）<br>QRZ ××× ON nnnn KHz（或MHz）<br>QSX ××× ON nnnn KHz（或MHz）<br>QRX ××× ON nnnn KHz（或MHz）	QSX ××× ON nnnn KHz（或MHz）
LK0318 “要我将频率改到nnnn频率吗”的业余无线电通信Q简语为：<br>QRV nnnn KHz（或MHz）？<br>QSY nnnn KHz（或MHz）？<br>QRY nnnn KHz（或MHz）？<br>QSV nnnn KHz（或MHz）？	QSY nnnn KHz（或MHz）？
LK0319 “请将频率改到nnnn频率”的业余无线电通信Q简语为：<br>QSU nnnn KHz（或MHz）<br>QSY nnnn KHz（或MHz）<br>QRY nnnn KHz（或MHz）<br>QRO nnnn KHz（或MHz）	QSY nnnn KHz（或MHz）
LK0320 “你的电台位置在哪里”的业余无线电通信Q简语为：<br>QRA？<br>QSZ？<br>QSA？<br>QTH？	QTH？
LK0321 “我的电台位置是××××”的业余无线电通信Q简语为：<br>QRD　××××<br>QSP　××××<br>QTH　××××<br>QSL　××××	QTH　××××
LK0322 “我的信号强度如何”的业余无线电通信Q简语为：<br>QSB？<br>QSA？<br>QTU？<br>QSD？	QSA？
LK0323 “你的信号强度为×级（1-5级）”的业余无线电通信Q简语为：<br>QSA ×<br>QSL ×<br>QRY<br>QRM ×	QSA ×
LK0324 业余无线电通信常用缩语“ABT”的意思是：<br>电池<br>关于、大约<br>衰减<br>在…之上	关于、大约
LK0325 “地址”的业余无线电通信常用缩语是：<br>ABT<br>ATT<br>ABV<br>ADR或ADDR	ADR或ADDR
LK0326 业余无线电常用缩语“ATT”的意思是：<br>衰落<br>关于、大约<br>衰减<br>地址	衰减
LK0327 业余无线电常用缩语“PWR”的意思是：<br>读写<br>报告<br>中继台<br>功率	功率
LK0328 “再”、“再来一次”的业余无线电通信常用缩语是：<br>ABV<br>GA<br>AGN<br>ABT	AGN
LK0329 业余无线电通信常用缩语“GA”的意思是：<br>姑娘<br>继续、请过来<br>垂直地网天线<br>公安	继续、请过来
LK0330 业余无线电通信常用缩语“AHR”的意思是：<br>这里<br>天线<br>地址<br>另一个	另一个
LK0331 “天线”的业余无线电通信常用缩语是：<br>ATR<br>ATN<br>ANT<br>ATT	ANT
LK0332 业余无线电常用缩语“ARDF”的意思是：<br>业余无线电测向<br>地址<br>天线测试仪<br>天线调谐器、天调	业余无线电测向
LK0333 “收听”的业余无线电常用缩语是：<br>HR<br>KP<br>GA<br>RCV	KP
LK0334 业余无线电常用缩语“HST”的意思是：<br>信号报告<br>通播<br>这里、听到<br>快速收发报	快速收发报
LK0335 业余无线电CW通信常用缩语“AS”（经常连发在一起）的意思是：<br>请稍等<br>关于<br>全部<br>天线	请稍等
LK0336 业余无线电通信常用缩语“AS”的意思有：<br>关于<br>回答<br>天线开关<br>请稍等、亚洲、如同	请稍等、亚洲、如同
LK0337 业余无线电通信常用词语“BEST”的意思是：<br>信号报告<br>电池组<br>通播电报<br>最好的	最好的
LK0338 业余无线电通信常用缩语“BJT”的意思是：<br>双基极二极管<br>北京时间<br>双极型半导体管<br>结型场效应半导体管	北京时间
LK0339 业余无线电通信常用缩语“BK”的意思是：<br>结束工作<br>千字节（单位）<br>插入、打断<br>请马上回答	插入、打断
LK0340 “QSL卡片管理局”的业余无线电通信常用缩语是：<br>BURO<br>BOUR<br>BRUO<br>BROU	BURO
LK0341 “遇到”、“见面”的业余无线电通信常用缩语是：<br>MET<br>MTRS<br>SE<br>C	C
LK0342 业余无线电通信常用缩语“CFM”的意思是：<br>法拉<br>确认<br>呼叫<br>调频	确认
LK0343 业余无线电通信常用词语“CHEERIO”的意思是：<br>英文字符<br>圣诞节<br>再次见面<br>再会、祝贺	再会、祝贺
LK0344 业余无线电通信常用缩语“CL”、“CLS”、“CLG”的意思分别是：<br>确认、呼叫、清除<br>关闭（或呼叫）、呼号、呼叫<br>计数、云层、呼号<br>呼号、清除、关闭	关闭（或呼叫）、呼号、呼叫
LK0345 业余无线电通信常用词语“DATE”的意思是：<br>时间<br>地址<br>频率<br>日期	日期
LK0346 业余无线电通信常用缩语“DR”的意思是：<br>远距离<br>从<br>二极管<br>亲爱的	亲爱的
LK0347 单元（常用于天线振子）的业余无线电通信常用缩语是：<br>UNIT<br>YAGI<br>ANT<br>EL、ELE、ELS	EL、ELE、ELS
LK0348 业余无线电CW通信常用缩语“ES”的意思是：<br>和<br>从<br>请等待<br>是	和
LK0349 业余无线电通信常用缩语“FB”的意思是：<br>腐败<br>很好的<br>再见<br>美好的祝愿	很好的
LK0350 业余无线电通信常用词语“FINE”的意思是：<br>调谐<br>好的，精细的<br>发现<br>确认	好的，精细的
LK0351 业余无线电通信常用缩语“FR”、“FER”的意思是：<br>频率<br>好的，精细的<br>希望<br>为了，对于	为了，对于
LK0352 “频率”的业余无线电通信常用缩语是：<br>FER<br>TUNE<br>FIND<br>FREQ	FREQ
LK0353 “下午好”的业余无线电通信常用缩语是：<br>GE<br>GA<br>GN<br>GM	GA
LK0354 “早晨好”的业余无线电通信常用缩语是：<br>GL<br>GB<br>GA<br>GM	GM
LK0355 “晚上好”的业余无线电通信常用缩语是：<br>GA<br>GE<br>GN<br>GM	GE
LK0356 业余无线电通信常用缩语“GN”的意思是：<br>好运气<br>晚安<br>高兴<br>早晨好	晚安
LK0357 “再见”的业余无线电通信常用缩语是：<br>GB<br>GA<br>GE<br>GL	GB
LK0358 业余无线电通信常用缩语“GL”的意思是：<br>晚安<br>早安<br>好运气<br>再见	好运气
LK0359 业余无线电通信常用缩语“GLD”的意思是：<br>再见<br>高兴<br>地线，地面<br>好运气	高兴
LK0360 业余无线电通信常用缩语“GMT”的意思是：<br>高兴<br>地线，地面<br>格林威治时间<br>好运气	格林威治时间
LK0361 业余无线电通信常用缩语“GND”的意思是：<br>格林威治时间<br>高兴<br>好运气<br>地线，地面	地线，地面
LK0362 “抄收”的业余无线电通信常用缩语是：<br>HPI<br>HPY<br>CPI<br>CFM	CPI
LK0363 “希望”的业余无线电通信常用缩语是：<br>HPE<br>HPY<br>CPI<br>HPI	HPE
LK0364 业余无线电通信常用缩语“HPY”、“HPI”的意思是：<br>这里<br>幸福<br>希望<br>抄收	幸福
LK0365 业余无线电通信常用缩语“HR”的意思是：<br>这里、听到<br>希望<br>幸福<br>号码	这里、听到
LK0366 “怎样”、“如何”的业余无线电通信常用缩语是：<br>HPI<br>CW<br>HW<br>HR	HW
LK0367 “很多”的业余无线电通信常用缩语是：<br>MNY、MNI<br>NAME<br>VY<br>ALL	MNY、MNI
LK0368 业余无线电通信常用缩语“MTRS”的意思是：<br>米<br>太太<br>小姐<br>先生	米
LK0369 “方式”的业余无线电通信常用英语是：<br>MODE<br>NICE<br>MTRS<br>NAME	MODE
LK0370 “名字”的业余无线电通信常用英语是：<br>MODE<br>MNI<br>NAME<br>NICE	NAME
LK0371 业余无线电通信常用词语“NICE”的意思是：<br>方式<br>名字<br>鼠标<br>良好的	良好的
LK0372 业余无线电通信常用缩语“NW”的意思是：<br>现在<br>不<br>怎样<br>新的	现在
LK0373 业余无线电通信常用缩语“OM”的意思是：<br>欧姆<br>老人<br>老朋友<br>或者	老朋友
LK0374 “操作员”的业余无线电通信常用缩语是：<br>OP、OPR<br>RPT<br>CPI<br>OM	OP、OPR
LK0375 “邮政信箱”的业余无线电通信常用缩语是：<br>QTH<br>MAIL<br>BURO<br>P O BOX	P O BOX
LK0376 “电台设备”的业余无线电通信常用缩语是：<br>SB<br>RIG<br>REG<br>EQP	RIG
LK0377 业余无线电通信常用缩语“RMKS”的意思是：<br>备注、注释<br>业余无线电测向<br>中继台<br>报告	备注、注释
LK0378 “报告”的业余无线电通信常用缩语是：<br>RPRT<br>RMKS<br>MSG<br>PRT	RPRT
LK0379 “收信机”的业余无线电通信常用缩语是：<br>XCVR<br>RCVR，RX<br>XMTR<br>RMKS	RCVR，RX
LK0380 “发信机”的业余无线电通信常用缩语是：<br>TX、XMTR<br>XTL<br>VXO<br>VXCO	TX、XMTR
LK0381 “收发信机”的业余无线电通信常用缩语是：<br>XMTR<br>XTL<br>XVTR<br>XCVR	XCVR
LK0382 业余无线电通信常用缩语“SK”（通常在CW中连在一起拍发）的意思是：<br>开关<br>下次再见<br>结束通信<br>谢谢	结束通信
LK0383 “对不起”的业余无线电通信常用缩语是：<br>SK<br>SRI，SRY<br>TNX<br>AS	SRI，SRY
LK0384 “电台”的业余无线电通信常用缩语是：<br>QTH<br>ANT<br>SRY<br>STN	STN
LK0385 业余无线电通信常用缩语“SURE”的意思是：<br>短波收听者<br>对不起<br>电台<br>确实	确实
LK0386 业余无线电常用缩语“SWL”的意思是：<br>对不起<br>短波收听者<br>高兴<br>确认	短波收听者
LK0387 “温度”的业余无线电通信常用缩语是：<br>WX<br>TUNE<br>TEMP<br>TMPO	TEMP
LK0388 “谢谢”的业余无线电通信常用缩语是：<br>TRY<br>73<br>TNX，TKS<br>SRI，SRY	TNX，TKS
LK0389 业余无线电通信常用缩语“TU”的意思是：<br>发信机<br>天调、天线调谐器<br>谢谢你<br>电子管	谢谢你
LK0390 “世界协调时”的业余无线电通信常用缩语是：<br>UCT<br>CUT<br>TUC<br>UTC	UTC
LK0391 业余无线电通信常用缩语“VIA”的意思是：<br>声控<br>经、由<br>邮寄<br>美国之音	经、由
LK0392 “很”、“非常”的业余无线电通信常用缩语是：<br>VIA<br>VY<br>MNI<br>ALL	VY
LK0393 业余无线电通信常用缩语“WK”的意思是：<br>星期、工作<br>插入<br>瓦特<br>圣诞节	星期、工作
LK0394 业余无线电通信常用缩语“WKD”的意思是：<br>联络过、工作过<br>圣诞节<br>星期<br>天气	联络过、工作过
LK0395 业余无线电通信常用缩语“WTS”的意思是：<br>工作、联络<br>天气<br>瓦特<br>星期	瓦特
LK0396 业余无线电通信常用缩语“WX”的意思是：<br>联络、工作<br>天气<br>瓦特<br>星期	天气
LK0397 业余无线电通信常用缩语“XMAS”的意思是：<br>晶体<br>圣诞节<br>发信机<br>收发信机	圣诞节
LK0398 业余无线电通信常用缩语“XYL”的意思是：<br>发信机<br>姑娘<br>晶体<br>妻子、已婚女子	妻子、已婚女子
LK0399 业余无线电通信常用缩语“YL”的意思是：<br>小姐、女士<br>呼叫<br>好运气<br>你的	小姐、女士
LK0400 业余无线电通信常用缩语“TU”的意思是：<br>再见<br>美好的祝愿<br>谢谢你<br>结束联络	谢谢你
LK0401 “你的”或者“你是”的业余无线电通信常用缩语是：<br>TU<br>US<br>UR<br>FB	UR
LK0402 业余无线电通信常用缩语“73”的意思是：<br>希望下次再见<br>谢谢你<br>再见<br>向对方的致意、美好的祝愿	向对方的致意、美好的祝愿
LK0403 业余无线电通信常用缩语“88”的意思是：<br>向对方异性操作员的致意、美好的祝愿<br>谢谢你<br>祝对方发达、发财<br>再见	向对方异性操作员的致意、美好的祝愿
LK0404 业余无线电通话常用语“Roger”的用法是：<br>回答起始语，相当于“明白”，仅在已完全抄收对方刚才发送的信息时使用<br>回答起始语，表示开始发话了，任何情况都可使用<br>惯用口头语，相当于电话的“喂”，仅提起注意，不包含任何意义<br>回答起始语，相当于“听到”，用于能听到对方信号、但不一定能全部抄收的情况	回答起始语，相当于“明白”，仅在已完全抄收对方刚才发送的信息时使用
LK0405 业余无线电通信中常用的天线种类的缩写DP代表：<br>定向天线<br>长线天线<br>偶极天线<br>垂直天线	偶极天线
LK0406 业余无线电通信中常用的天线种类的缩写LW代表：<br>垂直天线<br>长线天线<br>定向天线<br>偶极天线	长线天线
LK0407 业余无线电通信中常用的天线种类的缩写GP代表：<br>定向天线<br>对数周期天线<br>偶极天线<br>垂直接地天线	垂直接地天线
LK0408 业余无线电通信中常用的天线种类的缩写BEAM代表：<br>定向天线<br>专指八木天线<br>垂直天线<br>偶极天线	定向天线
LK0409 业余无线电通信中常用的天线种类的缩写YAGI代表：<br>八木天线<br>定向天线<br>垂直天线<br>偶极天线	八木天线
LK0410 业余无线电通信中常用的天线种类的缩写VER代表：<br>定向天线<br>偶极天线<br>垂直接地天线<br>垂直天线	垂直天线
LK0411 业余无线电技术常提到的天线种类的缩写LP代表：<br>垂直接地天线<br>对数周期天线<br>定向天线<br>垂直天线	对数周期天线
LK0412 二极管在无线电技术里广泛用于整流或检波，主要是利用了它的下列性能：<br>单向导电<br>高频滤波<br>电流放大<br>过流保护	单向导电
LK0413 三极电子管的三个基本电极是：<br>源极、栅极、漏极<br>发射极、基极、集电极<br>正极、负极、接地极<br>阴极（灯丝）、栅极、屏极（板极）	阴极（灯丝）、栅极、屏极（板极）
LK0414 双极型半导体三极管的三个基本电极是：<br>正极、负极、接地极<br>源极、栅极、漏极<br>阴极（灯丝）、栅极、屏极（板极）<br>发射极、基极、集电极	发射极、基极、集电极
LK0415 场效应型半导体三极管的三个基本电极是：<br>发射极、基极、集电极<br>阴极（灯丝）、栅极、屏极（板极）<br>源极、栅极、漏极<br>正极、负极、接地极	源极、栅极、漏极
LK0416 可以组成完整无线电接收系统的功能部件组合是：<br>射频滤波器、变频器、音频滤波器<br>接收天线、解调器、输出部件<br>射频放大器、变频器、中频放大器<br>接收天线、射频放大器、中频放大器	接收天线、解调器、输出部件
LK0417 可以组成完整无线电发信系统的功能部件组合是：<br>射频振荡器、射频功率放大器、驻波测量电路<br>射频振荡器、调制器、发射天线<br>键控电路、侧音电路、天线调谐器<br>话音放大器、射频振荡器、射频功率放大器	射频振荡器、调制器、发射天线
LK0418 无线电发射机调制部件的作用是：<br>调整天馈系统的参数达到阻抗匹配<br>以电能转换效率最高的方式控制射频功率放大器的工作点<br>自动控制发射信号的频谱使其保持在核准的必要带宽范围内<br>以原始信号控制射频信号的幅度、频率、相位参数	以原始信号控制射频信号的幅度、频率、相位参数
LK0419 无线电通信选择不同调制方式的主要考虑因素是：<br>防止与附近发射机产生三阶互调、尽量降低本振相位噪声、采用高中频方案<br>改善天线阻抗匹配、尽量提高发射频率稳定度、尽量减少杂散发射<br>有利于提高接收机选择性、尽量提高话筒灵敏度、防止产生谐波干扰<br>信息在传递过程中的保真度、信号的抗干扰能力、尽量节省无线电频谱资源	信息在传递过程中的保真度、信号的抗干扰能力、尽量节省无线电频谱资源
LK0420 发射天线的作用是：<br>把无线电发射机输出的射频信号电流转换为热能<br>通过天线的增益对无线电发射机输出的射频信号加以放大<br>把无线电发射机输出的射频信号电流转换为空间的电磁波<br>把无线电发射机放大后的音频话音信号转换为音频电磁场	把无线电发射机输出的射频信号电流转换为空间的电磁波
LK0421 接收天线系统的作用是：<br>把空间的有用电磁波转换为热能<br>通过天线的增益将空间有用电磁波的能量加以放大<br>把空间的有用电磁波转换为射频电压电流信号<br>把空间的有用电磁波转换为音频电压电流信号	把空间的有用电磁波转换为射频电压电流信号
LK0422 保证业余无线电通信接收机优良接收能力的主要因素是：<br>良好的抗干扰能力，足够高的灵敏度，尽量低的本机噪声和信号失真<br>尽量宽的接收频率覆盖范围<br>尽量大的音频输出功率<br>尽量宽而平坦的音频频率响应	良好的抗干扰能力，足够高的灵敏度，尽量低的本机噪声和信号失真
LK0423 接收机解调部件的作用是：<br>从接收到的已调制射频信号中提取出载频分量<br>对接收到的射频信号进行宽带线性放大<br>对接收到的射频信号进行选频放大<br>从接收到的已调制射频信号中分离出原始信号	从接收到的已调制射频信号中分离出原始信号
LK0424 选择解调部件的主要应考因素是：<br>尽量对已调制信号加以放大<br>尽量提升已调制信号中的载频分量<br>尽量忠实地还原原始信号<br>尽量补偿接收到的射频信号的频率偏移	尽量忠实地还原原始信号
LK0425 能够确定直流电路中任何一个两端元件工作状况的基本参数包括：<br>通过电流、两端电压、电阻<br>驻波比、功率、阻抗<br>频率、电荷量、电场强度<br>波长、电压、电容量	通过电流、两端电压、电阻
LK0426 物理量“电流”描述的是：<br>电源所能供出的最大的电荷数量<br>流过电路的累计电荷数量<br>电荷在电路导体内的运动速度<br>单位时间内流过电路的电荷数量	单位时间内流过电路的电荷数量
LK0427 物理量“电压”描述的是：<br>电源把其它形式的能量转化为电能的能力<br>电源所能供出的最大的电荷数量<br>单位时间内流过电路的电荷数量<br>电源加在电路两端驱动电子流动的力量大小	电源加在电路两端驱动电子流动的力量大小
LK0428 物理量“电动势”描述的是：<br>电源把其它形式的能量转化为电能的能力<br>电源所能供出的最大的电荷数量<br>电源加在电路两端驱动电子流动的力量大小<br>单位时间内流过电路的电荷数量	电源把其它形式的能量转化为电能的能力
LK0429 物理量“电阻”描述的是：<br>电流克服电路阻力的能力大小<br>电路对电流的阻碍力大小<br>电路阻断电流所需要的过度时间<br>电路阻力所消耗的能量多少	电路对电流的阻碍力大小
LK0430 物理量“功率”描述的是：<br>电源总共能够做的功<br>单位时间里电所能够做的功<br>负载总共消耗的能量<br>电源所能供出的最大的电荷数量	单位时间里电所能够做的功
LK0431 电流的单位是：<br>欧（姆）<br>瓦（特）<br>安（培）<br>伏（特）	安（培）
LK0432 电压的单位是：<br>伏（特）<br>欧（姆）<br>瓦（特）<br>安（培）	伏（特）
LK0433 电阻的单位是：<br>欧（姆）<br>瓦（特）<br>伏（特）<br>安（培）	欧（姆）
LK0434 功率的单位是：<br>伏（特）<br>安（培）<br>瓦（特）<br>欧（姆）	瓦（特）
LK0435 电动势的单位是：<br>安（培）<br>伏（特）<br>欧（姆）<br>瓦（特）	伏（特）
LK0436 用电压表检查一节干电池两端电压，未使用时测得1.5伏左右，用旧后测得1.2伏左右。正确的说法是：<br>旧干电池的电动势为0<br>旧干电池的电动势为1.5伏<br>旧干电池的电动势为1.35伏<br>旧干电池的电动势为1.2伏	旧干电池的电动势为1.5伏
LK0437 用甲乙两块电压表检查一节新干电池两端电压，均测得1.5伏。检查一节旧干电池，读数分别为1.2伏和1.3伏。正确的结论是：<br>甲电压表的精度低于乙电压表<br>甲电压表的内阻小于乙电压表<br>甲电压表的精度高于乙电压表<br>甲电压表的内阻大于乙电压表	甲电压表的内阻小于乙电压表
LK0438 电源两端电压的方向为：<br>从电源的负极到正极<br>从电源的正极到负极<br>取决于负载电阻和电源内阻的相对大小<br>与电源的电动势方向相同	从电源的正极到负极
LK0439 电源两端电动势的方向为：<br>从电源的负极到正极<br>与电源的电动势方向相同<br>从电源的正极到负极<br>取决于负载电阻和电源内阻的相对大小	从电源的负极到正极
LK0440 直流电路欧姆定律是说：<br>流过电阻的电流I，与两端的电压U成正比，与阻值R成反比<br>流过电阻的电流I，与两端的电压U成反比，与阻值R成正比<br>流过电阻的电流I，与两端的电压U成反比，与阻值R成反比<br>流过电阻的电流I，与两端的电压U成正比，与阻值R成正比	流过电阻的电流I，与两端的电压U成正比，与阻值R成反比
LK0441 将一个电阻为R的负载接到电压为U的电源上。负载中的电流Ｉ和负载消耗的功率Ｐ分别为：（U、I、R、P的单位分别为伏特、安培、欧姆、瓦特，”x＾m”表示“x的m次方”）<br>I = U×R，P =U/R<br>I = R/U，P =U×R<br>I = U×R，P =U＾2×R<br>I = U/R，P = U＾2/R	I = U/R，P = U＾2/R
LK0442 一个电阻为R的负载中流过的电流为Ｉ。其两端的电压U所消耗的功率Ｐ分别为：（U、I、R、P的单位分别为伏特、安培、欧姆、瓦特，”x＾m”表示“x的m次方”）<br>U = I + R，P =I ×R<br>U = I×R，P = I＾2×R<br>U = R / I，P = R / I＾2<br>U = I / R，P = I＾2/R	U = I×R，P = I＾2×R
LK0443 一个电阻负载两端电压为U，流过的电流为I。它的电阻R和所消耗的功率P分别为：（U、I、R、P的单位分别为伏特、安培、欧姆、瓦特，”x＾m”表示“x的m次方”）<br>R = U×I，P = U/ I＾2<br>R = I / U，P = U＾2/I<br>R = U/I，P = U×I<br>R = U＾2/I，P = U＾2×I	R = U/I，P = U×I
LK0444 一个电阻负载两端电压为U，所消耗的功率为P。流过负载的电流I和负载的电阻R分别为：（U、I、R、P的单位分别为伏特、安培、欧姆、瓦特，”x＾m”表示“x的m次方”）<br>I = P/U，R = U＾2/P<br>I = P×U，R = P/U<br>I = P/ U＾2，R = P×U<br>I = U/P，R = P/U	I = P/U，R = U＾2/P
LK0445 有阻值分别为R1和R2的两个负载，其中R1的电阻值是R2的N倍，把它们并联后接到电源上，则：（”x＾m”表示“x的m次方”）<br>流过R1的电流是R2的N倍，R1消耗的功率是R2的N＾2倍<br>流过R1的电流是R2的1/N，R1消耗的功率是R2的1/N<br>流过R1的电流与R2的相同，R1消耗的功率是R2的N倍<br>流过R1的电流与R2的相同，R1消耗的功率是R2的1/N＾2	流过R1的电流是R2的1/N，R1消耗的功率是R2的1/N
LK0446 有阻值分别为R1和R2的两个负载，其中R1的电阻值是R2的N倍，把它们并联后接到电源上，则：（”x＾m”表示“x的m次方”）<br>R1两端的电压与R2的相同，R1消耗的功率是R2的N＾2倍<br>R1两端的电压与R2的相同，R1消耗的功率是R2的1/N<br>R1两端的电压是R2的N倍，R1消耗的功率是R2的N＾2倍<br>R1两端的电压是R2的1/N，R1消耗的功率是R2的1/N＾2	R1两端的电压与R2的相同，R1消耗的功率是R2的1/N
LK0447 有阻值分别为R1和R2的两个负载，其中R1的电阻值是R2的N倍，把它们串联后接到电源上，则：（”x＾m”表示“x的m次方”）<br>流过R1的电流与R2的相同，R1消耗的功率是R2的N倍<br>流过R1的电流是R2的1/N，R1消耗的功率是R2的1/N＾2<br>流过R1的电流与R2的相同，R1消耗的功率是R2的1/N<br>流过R1的电流是R2的N倍，R1消耗的功率是R2的N＾2倍	流过R1的电流与R2的相同，R1消耗的功率是R2的N倍
LK0448 有阻值分别为R1和R2的两个负载，其中R1的电阻值是R2的N倍，把它们串联后接到电源上，则：（”x＾m”表示“x的m次方”）<br>R1两端的电压与R2的相同，R1消耗的功率是R2的1/N<br>R1两端的电压是R2的N倍，R1消耗的功率是R2的N倍<br>R1两端的电压与R2的相同，R1消耗的功率是R2的N＾2倍<br>R1两端的电压是R2的1/N，R1消耗的功率是R2的1/N＾2	R1两端的电压是R2的N倍，R1消耗的功率是R2的N倍
LK0449 已知A、B两个设备的工作电压相同，A的耗电功率是B的N倍。则：（”x＾m”表示“x的m次方”）<br>A的工作电流是B的N＾2倍<br>A的工作电流是B的1/N倍<br>A的工作电流是B的N＾(1/2)倍<br>A的工作电流是B的N倍	A的工作电流是B的N倍
LK0450 已知A、B两个设备的工作电压相同，A的额定电流是B的N倍。则：（”x＾m”表示“x的m次方”）<br>A的耗电功率是B的N＾(1/2)倍<br>A的耗电功率是B的N＾2倍<br>A的耗电功率是B的1/N倍<br>A的耗电功率是B的N倍	A的耗电功率是B的N倍
LK0451 将N个相同的电阻负载串联后接到电源上。与每个负载单独接到电源相比：（”x＾m”表示“x的m次方”）<br>串联后流过每个电阻的电流减少到1/N，每个电阻的耗电功率减少到1/N<br>串联后流过每个电阻的电流减少到1/N，每个电阻的耗电功率减少到1/N＾2<br>串联后流过每个电阻的电流不变，每个电阻的耗电功率减少到1/N<br>串联后流过每个电阻的电流增加到N倍，每个电阻的耗电功率增加到N＾2倍	串联后流过每个电阻的电流减少到1/N，每个电阻的耗电功率减少到1/N＾2
LK0452 将N个相同的电阻负载串联后接到电源上。与每个负载单独接到电源相比：（”x＾m”表示“x的m次方”）<br>串联后每个电阻两端的电压减少到1/N，每个电阻的耗电功率减少到1/ N＾2<br>串联后每个电阻两端的电压减少到1/N，每个电阻的耗电功率减少到1/N<br>串联后每个电阻两端的电压增加到N倍，每个电阻的耗电功率增加到N＾2倍<br>串联后每个电阻两端的电压不变，每个电阻的耗电功率减少到1/N	串联后每个电阻两端的电压减少到1/N，每个电阻的耗电功率减少到1/ N＾2
LK0453 将N个相同的电阻负载并联后接到电源上。与每个负载单独接到电源相比：（”x＾m”表示“x的m次方”）<br>并联后流过每个电阻的电流增加到N倍，两个电阻的总耗电功率增加到N＾2倍<br>并联后流过每个电阻的电流不变，所有电阻的总耗电功率增加到N＾2倍<br>并联后流过每个电阻的电流减少到1/N，两个电阻的总耗电功率减少到1/N＾2<br>并联后流过每个电阻的电流不变，所有电阻的总耗电功率增加到N倍	并联后流过每个电阻的电流不变，所有电阻的总耗电功率增加到N倍
LK0454 将N个相同的电阻负载并联后接到电源上。与每个负载单独接到电源相比：（”x＾m”表示“x的m次方”）<br>并联后每个电阻两端的电压不变，所有电阻的总耗电功率增加到N倍<br>并联后每个电阻两端的电压减少到1/N，两个电阻的总耗电功率减少到1/N＾2<br>并联后每个电阻两端的电压不变，所有电阻的总耗电功率增加到N＾2倍<br>并联后每个电阻两端的电压增加到N倍，两个电阻的总耗电功率增加到N＾2倍	并联后每个电阻两端的电压不变，所有电阻的总耗电功率增加到N倍
LK0455 一个电阻负载，如果将其两端的工作电压提高百分之N，则：（”x＾m”表示“x的m次方”）<br>耗电量比原来的增加百分之N<br>耗电量比原来的增加[百分之N]＾2<br>耗电量增加到原来的百分之（100+N）<br>耗电量增加到原来的[百分之（100+N）]＾2	耗电量增加到原来的[百分之（100+N）]＾2
LK0456 一个电阻负载，如果将其两端的工作电压降低百分之N，则：（”x＾m”表示“x的m次方”）<br>耗电量减少到原来的[百分之（100-N）]＾2<br>耗电量比原来的减少[百分之N]＾2<br>耗电量比原来的减少百分之N<br>耗电量减少到原来的百分之（100-N）	耗电量减少到原来的[百分之（100-N）]＾2
LK0457 一部业余无线电台，工作电压直流13.8伏，FM发射方式的射频输出载波功率为N瓦，电源效率约80%。发射时的工作电流约为：<br>13.8/Ｎ×80%（安）<br>0.091×Ｎ（安）<br>13.8×Ｎ（安）<br>0.058×Ｎ（安）	0.091×Ｎ（安）
LK0458 一部业余无线电台，工作电压交流220伏，FM发射方式的射频输出载波功率为N瓦，电源效率约80%。发射时的工作电流约为：<br>0.0057×Ｎ（安）<br>0.0036×Ｎ（安）<br>220×Ｎ（安）<br>200/Ｎ×80%（安）	0.0057×Ｎ（安）
LK0459 一部业余无线电台，FM发射方式的射频输出载波功率为N瓦，电源效率约80%。通话时每发射10秒钟的电源消耗约为：<br>0.0022×Ｎ（千瓦小时）<br>0.0000035×Ｎ（千瓦小时）<br>220 / Ｎ（千瓦小时）<br>0.0768 /Ｎ（千瓦小时）	0.0000035×Ｎ（千瓦小时）
LK0460 一部业余无线电台，FM发射方式的射频输出载波功率为10瓦，电源效率约80%。连续发话10秒钟，在此期间发射到空间的平均功率：<br>约为12.5瓦<br>约为10瓦<br>肯定高于10瓦<br>约为8瓦	约为10瓦
LK0461 一部业余无线电台，CW发射方式的射频输出载波功率为10瓦，电源效率约80%。连续发报10秒钟，在此期间发射到空间的平均功率：<br>约为12.5瓦<br>约为10瓦<br>约为8瓦<br>显著低于10瓦	显著低于10瓦
LK0462 一部业余无线电台，SSB发射方式的射频输出峰包功率为10瓦，电源效率约80%。连续发话10秒钟，在此期间发射到空间的平均功率：<br>约为8瓦<br>约为12.5瓦<br>显著低于10瓦<br>约为10瓦	显著低于10瓦
LK0463 一部业余无线电台，SSB发射方式的射频输出峰包功率为10瓦，电源效率约80%。在此方式下连续发送RTTY信号10秒钟，在此期间发射到空间的平均功率：<br>约为10瓦<br>显著低于10瓦<br>约为12.5瓦<br>约为8瓦	约为10瓦
LK0464 一部业余无线电台，SSB发射方式的射频输出峰包功率为10瓦，电源效率约80%。在此方式下连续发送PSK31信号10秒钟，在此期间发射到空间的平均功率：<br>约为10瓦<br>显著低于10瓦<br>约为12.5瓦<br>约为8瓦	约为10瓦
LK0465 一部业余无线电台，SSB发射方式的射频输出峰包功率为10瓦，电源效率约80%。在此方式下连续发送SSTV信号10秒钟，在此期间发射到空间的平均功率：<br>约为8瓦<br>约为12.5瓦<br>约为10瓦<br>显著低于10瓦	约为10瓦
LK0466 无线电常用度量单位的词头K的意义为：（”x＾m”表示“x的m次方”）<br>10＾(-3)<br>10＾3<br>10＾6<br>10＾(-6)	10＾3
LK0467 无线电常用度量单位的词头m的意义为：（”x＾m”表示“x的m次方”）<br>10＾6<br>10＾(-6)<br>10＾3<br>10＾(-3)	10＾(-3)
LK0468 无线电常用度量单位的词头M的意义为：（”x＾m”表示“x的m次方”）<br>10＾6<br>10＾(-6)<br>10＾(-3)<br>10＾3	10＾6
LK0469 无线电常用度量单位的词头μ的意义为：（”x＾m”表示“x的m次方”）<br>10＾6<br>10＾(-3)<br>10＾(-6)<br>10＾3	10＾(-6)
LK0470 无线电常用度量单位的词头G的意义分别为：（”x＾m”表示“x的m次方”）<br>10＾12<br>10＾(-12)<br>10＾6<br>10＾9	10＾9
LK0471 无线电常用度量单位的词头n的意义分别为：（”x＾m”表示“x的m次方”）<br>10＾9<br>10＾12<br>10＾(-12)<br>10＾(-9)	10＾(-9)
LK0472 无线电常用度量单位的词头T的意义分别为：（”x＾m”表示“x的m次方”）<br>10＾-12<br>10＾9<br>10＾(-9)<br>10＾12	10＾12
LK0473 无线电常用度量单位的词头p的意义分别为：（”x＾m”表示“x的m次方”）<br>10＾12<br>10＾(-12)<br>10＾9<br>10＾(-9)	10＾(-12)
LK0474 正弦交流电压或电流的峰值（peak value）是指：（”x＾m”表示“x的m次方”）<br>负半周最大幅度与正半周最大幅度的平均值<br>负半周最大幅度与正半周最大幅度的差值的二次方<br>从零点算起的最大值<br>一个周期内瞬时值的平均乘以值2＾(1/2)	从零点算起的最大值
LK0475 正弦交流电压或电流的峰值峰-峰值（peak to peak）是指：<br>从负半周峰值到正半周峰值之间的差<br>负半周最大幅度与正半周最大幅度的差值的二次方<br>从零点算起的最大值<br>负半周最大幅度与正半周最大幅度的差值的平方根	从负半周峰值到正半周峰值之间的差
LK0476 任意交流电压的有效值是指：（”x＾m”表示“x的m次方”）<br>最终转换成应用所需的有用能量的那部分电压值<br>电压的平均值乘以2＾(1/2)<br>在同一电阻上可以转换出与该交流电压效果相同的热量的直流电压<br>电压的峰值除以2＾(1/2)	在同一电阻上可以转换出与该交流电压效果相同的热量的直流电压
LK0477 用万用电表的交流电压档测量简单正弦交流电压，得到的读数是该电压的：<br>有效值<br>峰-峰值<br>最大值<br>平均值	有效值
LK0478 用万用电表的直流电压档测量简单正弦交流电压，得到的读数是该电压的：<br>零<br>最大值<br>有效值<br>峰-峰值	零
LK0479 用万用电表的直流电压档测量正负对称的方波电压（占空比为1），得到的读数是该电压的：<br>最大值的2倍<br>零<br>最大值<br>最大值的1/2	零
LK0480 用磁电式万用电表的交流电压档测量正负对称的方波电压，其指针指示的电压读数：<br>为平均值<br>比最大值大<br>为峰-峰值<br>为最大值	比最大值大
LK0481 用万用电表的直流电压档测量最小值为0的方波电压（占空比为1），得到的读数是该电压的：<br>最小值<br>最大值的1/2<br>最大值<br>最大值的2倍	最大值的1/2
LK0482 测量一个元件是否短路，应该使用：<br>万用电表的电流挡<br>万用电表的电压挡<br>万用电表的电阻挡<br>频谱分析仪	万用电表的电阻挡
LK0483 大致判断一个干电池是否已经失效，应该使用：<br>万用电表的电压挡<br>万用电表的电流挡<br>音频信号发生器<br>万用电表的电阻挡	万用电表的电压挡
LK0484 测量一个电解电容器是否完好，应该使用：<br>万用电表的电阻挡<br>万用电表的电流挡<br>蓄电池充电器<br>万用电表的电压挡	万用电表的电阻挡
LK0485 用万用电表的电阻档测量一支阻抗为50欧姆的四分之一波长接地天线，读数为0欧。则可以做出如下结论：<br>该天线肯定无法与输出阻抗为50欧姆的收发信机相匹配<br>该天线肯定已经短路损坏<br>该天线与地之间可能存在着由电感线圈构成的直流通路<br>该天线肯定无法与特性阻抗为50欧的馈线相匹配	该天线与地之间可能存在着由电感线圈构成的直流通路
LK0486 用万用电表的电阻挡测量一支阻抗为50欧姆的四分之一波长接地天线，读数为无穷大。则可以做出如下结论：<br>该天线肯定无法与输出阻抗为50欧姆的收发信机相匹配<br>该天线肯定已经开路损坏<br>该天线肯定无法与特性阻抗为50欧的馈线相匹配<br>该天线与地之间不存在由电感线圈构成的直流通路	该天线与地之间不存在由电感线圈构成的直流通路
LK0487 万用电表设在电阻挡，将表笔分别接到尚未连接BALUN和电缆等其它部件的每臂长度均为四分之一波长的偶极天线的中心馈电点两端，读数应为：<br>50欧姆<br>读数受振子周围物体的影响<br>无穷大<br>读数受表笔连线造成的驻波比的影响	无穷大
LK0488 万用电表设在电阻挡，将表笔分别接到一条终端开路的任意长度的50欧同轴电缆的中心导体和屏蔽层，读数应为：<br>50欧姆<br>无穷大<br>0欧姆<br>读数与电缆长度有关	无穷大
LK0489 万用电表设在电阻挡，将表笔分别接到一条终端短路的任意长度的理想50欧同轴电缆的中心导体和屏蔽层，读数应为：<br>无穷大<br>0欧姆<br>50欧姆<br>读数与电缆长度有关	0欧姆
LK0490 用万用电表的电阻挡测量一个常用元件的电阻，在R×1挡、R×10挡和R×100挡测的的读数有很大差别，分别为40欧、240欧和2000欧。正确的推论是：<br>万用表的电池肯定电量不足了<br>该元件肯定是一只损坏了的电阻<br>该元件是一个非线性元件（例如二极管）<br>万用表的准确度肯定有问题	该元件是一个非线性元件（例如二极管）
LK0491 用指针式万用电表的电阻挡测量一个常用元件，表笔第一次连接时表针挥动了一下，但很快回到零点，断开表笔重新连接，表针却不再有任何指示。正确的推论是：<br>该元件肯定是一只损坏了的电阻<br>万用表的准确度肯定有问题<br>万用表的电池肯定电量不足了<br>该元件可能是一个电解电容器	该元件可能是一个电解电容器
LK0492 万用电表的电压挡有一个“欧姆/伏（每伏欧姆）”的指标。每伏欧姆数越大，说明：<br>可以耐受的电压过载能力越弱<br>测量电压时电表对电路工作状态的影响越大<br>可以耐受的电压过载能力越强<br>测量电压时电表对电路工作状态的影响越小	测量电压时电表对电路工作状态的影响越小
LK0493 用万用电表的交流电压档测量电路中某两点间的等幅度音频信号电压，发现交换两支表笔时虽然都有指示，但得到的度数不相同。正确的推论是：<br>电表导线之间的分布电容造成了读数的误差<br>音频信号上叠加有直流成分，且电表电路采用了半波整流<br>电表精度太差<br>音频信号上叠加有直流成分，且电表电路采用了全波整流	音频信号上叠加有直流成分，且电表电路采用了半波整流
LK0494 用万用电表的交流电压档测量电路中某两点间的等幅度音频信号电压，得到一个读数，但在交换两支表笔后表针就根本没有偏转了，反复试验都是如此。正确的推论是：<br>电表精度太差<br>音频信号上叠加有直流成分，且电表电路采用了半波整流<br>音频信号上叠加有直流成分，且电表电路采用了全波整流<br>电表导线之间的分布电容造成了读数的误差	音频信号上叠加有直流成分，且电表电路采用了半波整流
LK0495 音频所指的频率范围大致是：<br>16kHz - 20kHz<br>300Hz - 3000Hz<br>16kHz - 56kHz<br>16Hz - 20kHz	16Hz - 20kHz
LK0496 亚音调静噪(CTCSS)是指附加在发射端信号中的一个亚音频控制音调。这个信号的频率范围大致是：<br>16Hz - 20kHz<br>220Hz - 2503Hz<br>16kHz - 20kHz<br>67Hz - 250.3Hz	67Hz - 250.3Hz
LK0497 附图中的电路元器件符号代表的是：<br><img src="LK0497.jpg"><br>二极管<br>电阻<br>接地<br>天线	接地
LK0498 附图中的电路元器件符号代表的是：<br><img src="LK0498.jpg"><br>接地<br>天线<br>二极管<br>电阻	天线
LK0499 附图中的电路元器件符号代表的是：<br><img src="LK0499.jpg"><br>电容<br>熔断器<br>二极管<br>电阻	熔断器
LK0500 附图中的电路元器件符号代表的是：<br><img src="LK0500.jpg"><br>熔断器<br>电阻<br>二极管<br>电容器	电容器
LK0501 附图中的电路元器件符号代表的是：<br><img src="LK0501.jpg"><br>压电晶体<br>电容器<br>电阻<br>熔断器	电阻
LK0502 附图中的电路元器件符号代表的是：<br><img src="LK0502.jpg"><br>线圈<br>二极管<br>电容器<br>电阻	二极管
LK0503 附图中的电路元器件符号代表的是：<br><img src="LK0503.jpg"><br>电容器<br>电阻<br>二极管<br>线圈	线圈
LK0504 附图中的电路元器件符号代表的是：<br><img src="LK0504.jpg"><br>二极管<br>电池<br>线圈<br>电阻	电池
LK0505 附图中的电路元器件符号代表的是：<br><img src="LK0505.jpg"><br>压电晶体<br>二极管<br>电阻<br>电池	压电晶体
LK0506 附图中的电路元器件符号代表的是：<br><img src="LK0506.jpg"><br>发光二极管<br>稳压二极管<br>压电晶体<br>电阻	稳压二极管
LK0507 附图中的电路元器件符号代表的是：<br><img src="LK0507.jpg"><br>压电晶体<br>发光二极管<br>稳压二极管<br>电阻	发光二极管
LK0508 附图中的电路元器件符号代表的是：<br><img src="LK0508.jpg"><br>结型场效应半导体三极管<br>NPN双极型半导体三极管<br>绝缘栅场效应半导体三极管<br>PNP双极型半导体三极管	PNP双极型半导体三极管
LK0509 附图中的电路元器件符号代表的是：<br><img src="LK0509.jpg"><br>PNP双极型半导体三极管<br>结型场效应半导体三极管<br>NPN双极型半导体三极管<br>绝缘栅场效应半导体三极管	NPN双极型半导体三极管
LK0510 附图中的电路元器件符号代表的是：<br><img src="LK0510.jpg"><br>NPN双极型半导体三极管<br>结型场效应半导体三极管<br>PNP双极型半导体三极管<br>绝缘栅场效应半导体三极管	结型场效应半导体三极管
LK0511 附图中的电路元器件符号代表的是：<br><img src="LK0511.jpg"><br>结型场效应半导体三极管<br>NPN双极型半导体三极管<br>PNP双极型半导体三极管<br>绝缘栅场效应半导体三极管	绝缘栅场效应半导体三极管
LK0512 峰-峰值为100伏的正弦交流电压，其有效值电压为：<br>约50伏<br>约141伏<br>约70.7伏<br>约35.4伏	约35.4伏
LK0513 峰值为100伏的正弦交流电压，其有效值电压为：<br>约141伏<br>约70.7伏<br>约35.4伏<br>约50伏	约70.7伏
LK0514 最小值为-50伏、峰-峰值为100伏的方波电压，其有效值电压为：<br>50伏<br>约70.7伏<br>100伏<br>约35.4伏	50伏
LK0515 最小值为0、峰-峰值为100伏的方波电压，其有效值电压为：<br>50伏<br>100伏<br>约70.7伏<br>约35.4伏	50伏
LK0516 最小值为-50伏、峰-峰值为100伏的三角波电压，其有效值电压为：<br>约70.7伏<br>50伏<br>100伏<br>25伏	25伏
LK0517 最小值为0、峰-峰值为100伏的三角波电压，其有效值电压为：<br>100伏<br>50伏<br>约70.7伏<br>25伏	50伏
LK0518 峰-峰值为100伏的正弦交流电压，其平均值电压为：<br>约141伏<br>约35.4伏<br>约70.7伏<br>0	0
LK0519 峰值为100伏的正弦交流电压，其平均值电压为：<br>约70.7伏<br>0<br>约141伏<br>约35.4伏	0
LK0520 最小值为-50伏、峰-峰值为100伏的方波电压，其平均值电压为：<br>0<br>100伏<br>50伏<br>约70.7伏	0
LK0521 最小值为0、峰-峰值为100伏的方波电压，其平均值电压为：<br>约70.7伏<br>约35.4伏<br>50伏<br>100伏	50伏
LK0522 最小值为-50伏、峰-峰值为100伏的三角波电压，其平均值电压为：<br>约70.7伏<br>25伏<br>0<br>50伏	0
LK0523 最小值为0、峰-峰值为100伏的三角波电压，其平均值电压为：<br>50伏<br>100伏<br>约70.7伏<br>25伏	50伏
LK0524 分别用电压为120V的蓄电池组和电压最大值为120V的交流变压器驱动同样的电阻负载，哪一个电阻每分钟发出的热量多？<br>蓄电池驱动的电阻所发的热量是交流变压器上的电阻的2倍左右<br>蓄电池驱动的电阻所发的热量是交流变压器上的电阻的0.7倍左右<br>蓄电池驱动的电阻所发的热量是交流变压器上的电阻的1.4倍左右<br>两个电源驱动的电阻发热相同	蓄电池驱动的电阻所发的热量是交流变压器上的电阻的2倍左右
LK0525 分别用电压为120V的蓄电池组和电压有效值为120V的交流变压器驱动同样的电阻负载，哪一个电阻每分钟发出的热量多？<br>两个电源驱动的电阻发热相同<br>蓄电池驱动的电阻所发的热量是交流变压器上的电阻的2倍左右<br>蓄电池驱动的电阻所发的热量是交流变压器上的电阻的1.4倍左右<br>蓄电池驱动的电阻所发的热量是交流变压器上的电阻的0.7倍左右	两个电源驱动的电阻发热相同
LK0526 分别用电压为120V的蓄电池组和电压有效值为120V的交流变压器串联二极管后驱动同样的电阻负载，哪一个电阻每分钟发出的热量多？（忽略二极管的电压降）<br>蓄电池驱动的电阻所发的热量是交流变压器上的电阻的2倍左右<br>两个电源驱动的电阻发热相同<br>蓄电池驱动的电阻所发的热量是交流变压器上的电阻的1.4倍左右<br>蓄电池驱动的电阻所发的热量是交流变压器上的电阻的0.7倍左右	蓄电池驱动的电阻所发的热量是交流变压器上的电阻的2倍左右
LK0527 分别用电压为120V的蓄电池组和电压最大值为120V的交流变压器经过带电容滤波的全波整流电路驱动同样的电阻负载，哪一个电阻每分钟发出的热量多？（忽略整流器的电压降）<br>蓄电池驱动的电阻所发的热量是交流变压器上的电阻的1.4倍左右<br>两个电源驱动的电阻发热相同<br>蓄电池驱动的电阻所发的热量是交流变压器上的电阻的0.7倍左右<br>蓄电池驱动的电阻所发的热量是交流变压器上的电阻的2倍左右	两个电源驱动的电阻发热相同
LK0528 分别用电压有效值为120V、频率为50Hz的交流电源和电压有效值为120V、频率为10kHz的方波电源驱动同样的电阻负载，哪一个电阻每分钟发出的热量多？<br>10kHz电路电阻所发的热量是50Hz电路电阻的200倍左右<br>10kHz电路电阻所发的热量是50Hz电路电阻的5倍左右<br>10kHz电路电阻所发的热量是50Hz电路电阻的1/5倍左右<br>两个电源驱动的电阻发热相同	两个电源驱动的电阻发热相同
LK0529 相位差通常用来描述：<br>两个或多个同频率正弦信号之间的时间滞后或超前关系<br>两个或多个随机信号之间的时间滞后或超前关系<br>两个或多个不同频率正弦信号之间的时间滞后或超前关系<br>两个或多个任意信号之间的幅度关系	两个或多个同频率正弦信号之间的时间滞后或超前关系
LK0530 把两个幅度相等、相位相差360°的正弦电压信号源相串联，得到的是：<br>电压为0<br>幅度与单个信号源的相同、频率比原信号高一倍的正弦电压<br>幅度为单个信号源的2倍、相位与原信号源相同的正弦电压<br>幅度与单个信号源的相同、相位与原信号源相差180°的正弦电压	幅度为单个信号源的2倍、相位与原信号源相同的正弦电压
LK0531 把两个幅度相等、相位相差180°的正弦电压信号源相串联，得到的是：<br>幅度与单个信号源的相同、相位与原信号源相差90°的正弦电压<br>幅度与单个信号源的相同、频率比原信号高一倍的正弦电压<br>幅度为单个信号源的2倍、相位与原信号源相同的正弦电压<br>电压为0	电压为0
LK0532 把两个幅度相等、相位相差90°的正弦电压信号源相串联，得到的是：<br>幅度为单个信号源的2倍、相位与原信号源相同的正弦电压<br>幅度与单个信号源的相同、相位与原信号源相差45°的正弦电压<br>幅度为单个信号源的1.41倍、相位与原信号源相差45°的正弦电压<br>幅度与单个信号源的相同、频率比原信号高一倍的正弦电压	幅度为单个信号源的1.41倍、相位与原信号源相差45°的正弦电压
LK0533 一个频率为F的简单正弦波信号的频谱包含有：<br>频率为F的整数倍的无穷多个频率分量<br>频率为F的一个频率分量<br>无穷多个连续的频率分量<br>频率为F的奇数倍的无穷多个频率分量	频率为F的一个频率分量
LK0534 一个重复频率为F的非正弦周期信号的频谱包含有：<br>频率为F的整数倍的无穷多个频率分量<br>频率为F以外的无穷多个频率分量<br>无穷多个连续的频率分量<br>频率为F的一个频率分量	频率为F的整数倍的无穷多个频率分量
LK0535 只包含一个频率分量的信号是：<br>对称方波<br>单个无限窄脉冲<br>连续的无限窄脉冲<br>简单正弦波	简单正弦波
LK0536 在整个频谱内具有连续的均匀频率分量的信号是：<br>连续的无限窄脉冲<br>简单正弦波<br>对称方波<br>单个无限窄脉冲	单个无限窄脉冲
LK0537 电源（或信号源）内阻对电路的影响是：<br>使电源（或信号源）的电动势降低<br>使电源（或信号源）的实际输出电压降低<br>减少电源（或信号源）本身的电能消耗<br>使电源（或信号源）的可输出功率增加	使电源（或信号源）的实际输出电压降低
LK0538 从能量转换的观点，“匹配”是指：<br>选择电路参数，使负载能够得到最高实际输出电压的状态<br>选择电路参数，使负载能够得到最高实际输出功率的状态<br>选择电路参数，使负载能够得到最高实际输出电流的状态<br>选择电路参数，使电源内阻能够达到最小功率损耗的状态	选择电路参数，使负载能够得到最高实际输出功率的状态
LK0539 信号源和负载达到阻抗“匹配”时，信号源内阻损耗的功率为：<br>损耗功率为零<br>是负载得到的输出功率的一半<br>与负载得到的输出功率相比可以忽略不计<br>与负载得到的输出功率相等	与负载得到的输出功率相等
LK0540 一个放大器具有20dB的信号增益，其意义是：<br>放大器把相输入信号的能量放大了99倍<br>放大器把相当于输入信号的100倍的能量从电源转移到了输出负载<br>放大器把相输入信号的能量放大了100倍<br>放大器产生了当于输入信号的100倍的能量，供给了输出负载	放大器把相当于输入信号的100倍的能量从电源转移到了输出负载
LK0541 射频信号通过某电路时产生了20dB的损耗。这部分被损耗的能量：<br>返回了信号源<br>在电路中被转化为热能等其他形式，或者通过电磁辐射等转移到了其他地方<br>在电路中消失了<br>一部分在电路中消失了，一部分返回了信号源	在电路中被转化为热能等其他形式，或者通过电磁辐射等转移到了其他地方
LK0542 某电路输出信号功率是输入信号功率的100倍，该电路的增益为：<br>20dB<br>100dB<br>1dB<br>10dB	20dB
LK0543 某电路输出信号功率是输入信号功率的100万倍，该电路的增益为：<br>100万dB<br>60dB<br>100dB<br>99万dB	60dB
LK0544 某电路输出信号功率是输入信号功率的5倍，该电路的增益约为：<br>7dB<br>5dB<br>3.5dB<br>14dB	7dB
LK0545 某电路输出信号功率是输入信号功率的2倍，该电路的增益约为：<br>3dB<br>1dB<br>2dB<br>0.5dB	3dB
LK0546 某电路输出信号电压是输入信号电压的100倍，该电路的增益为：<br>20dB<br>40dB<br>10dB<br>100dB	40dB
LK0547 某电路输出信号电压是输入信号电压的1万倍，该电路的增益为：（”x＾m”表示“x的m次方”）<br>10,000 dB<br>9,999 dB<br>80dB<br>10＾4dB	80dB
LK0548 某电路输出信号电压是输入信号电压的10倍，该电路的增益约为：<br>7dB<br>15dB<br>20dB<br>14dB	20dB
LK0549 某电路输出信号电压是输入信号电压的2倍，该电路的增益约为：<br>6dB<br>0.5dB<br>2dB<br>4dB	6dB
LK0550 某电路输出信号功率是输入信号功率的1/100，该电路的增益为：<br>-10dB<br>-100dB<br>-20dB<br>100dB	-20dB
LK0551 某电路输出信号功率是输入信号功率的百万分之一，该电路的增益为：<br>-100dB<br>990000dB<br>-1000000dB<br>-60dB	-60dB
LK0552 某电路输出信号功率是输入信号功率的1/5，该电路的增益约为：<br>3.5dB<br>-5dB<br>-7dB<br>-14dB	-7dB
LK0553 某电路输出信号功率是输入信号功率的1/2，该电路的增益约为：<br>0.5dB<br>-3dB<br>-2dB<br>-1dB	-3dB
LK0554 某电路输出信号电压是输入信号电压的1/100，该电路的增益为：<br>-20dB<br>-10dB<br>-100dB<br>-40dB	-40dB
LK0555 某电路输出信号电压是输入信号电压的万分之一，该电路的增益为：（”x＾m”表示“x的m次方”）<br>-80dB<br>1/10,000 dB<br>10＾-4dB<br>-10,000 dB	-80dB
LK0556 某电路输出信号电压是输入信号电压的1/10倍，该电路的增益约为：<br>0.143dB<br>-20dB<br>-14dB<br>-7dB	-20dB
LK0557 某电路输出信号电压是输入信号电压的1/2，该电路的增益约为：<br>-0.5dB<br>-2dB<br>-6dB<br>0.5dB	-6dB
LK0558 信号依次通过增益分别为 x dB、y dB和 z dB的三个电路，总增益为：<br>（x + y + z）dB<br>（x × y × z）倍<br>（x + y + z）倍<br>（x × y × z）dB	（x + y + z）dB
LK0559 信号依次通过增益分别为 x dB、y dB和 z dB的三个电路，总增益为：（”x＾m”表示“x的m次方”）<br>（x + y + z）倍<br>10＾（x × y × z） 倍<br>10＾(（x + y + z）/10) 倍<br>（x × y × z）倍	10＾(（x + y + z）/10) 倍
LK0560 接收机的接收信号强度表每两档的信号强度相差6dB。接收某电台信号，发射功率为20dBW时读数为S9。该台减小发射功率后，接收机读数变为S4。此时该台的发射功率约为（以W为单位）：<br>0.156W<br>1.73W<br>0.098W<br>10.24W	0.098W
LK0561 接收机的接收信号强度表每两档的信号强度相差6dB。接收某电台信号，发射功率为10dBW时读数为S8。该台减小发射功率后，接收机读数变为S5。此时该台的发射功率约为（以W为单位）：<br>1.73W<br>0.156W<br>10.24W<br>0.098W	0.156W
LK0562 功率为0 dBm的射频信号通过增益为 23 dB的电路后，输出功率为：<br>0.23W<br>23W<br>0.2W<br>23mW	0.2W
LK0563 功率为0dBμ的射频信号通过增益为 36 dB的电路后，输出功率为：<br>360μW<br>4mW<br>3.6W<br>36mW	4mW
LK0564 功率为0 dBW的射频信号通过增益为 -36 dB的电路后，输出功率为：<br>25mW<br>360μW<br>0.25 mW<br>3.6mW	0.25 mW
LK0565 功率为0 dBW的射频信号通过衰减量为 40 dB的衰减器后，输出功率为：<br>0.40 W<br>100μW<br>40mW<br>140μW	100μW
LK0566 5W可以表示为：<br>5dBW<br>17dBm<br>35dBμ<br>37dBm	37dBm
LK0567 0.25W可以表示为：<br>25dBm<br>36dBm<br>54dBμ<br>6dBW	54dBμ
LK0568 0.4kW可以表示为：<br>6000dBm<br>400dBm<br>34dBm<br>86dBμ	86dBμ
LK0569 “频率失真”是指电路的输出信号波形与输入信号相比，发生了下列变化：<br>各频率分量的比例发生了改变<br>不同频率分量的相位延迟差发生了改变<br>产生了新的频率分量<br>信号的幅度发生了改变	各频率分量的比例发生了改变
LK0570 “非线性失真”是指电路的输出信号波形与输入信号相比，发生了下列变化：<br>各频率分量的比例发生了改变<br>产生了新的频率分量<br>信号的幅度发生了改变<br>不同频率分量的相位延迟差发生了改变	产生了新的频率分量
LK0571 “相位失真”是指电路的输出信号波形与输入信号相比，发生了下列变化：<br>信号的幅度发生了改变<br>各频率分量的比例发生了改变<br>不同频率分量的相位延迟差发生了改变<br>产生了新的频率分量	不同频率分量的相位延迟差发生了改变
LK0572 包含多个频率分量的信号通过滤波器会发生下列现象：<br>频率失真<br>检波<br>非线性失真<br>自激振荡	频率失真
LK0573 要防止HF发射机的杂散发射干扰天线附近的VHF电视机，应该发射机和天线之间串联：<br>截止频率为30MHz左右的高通滤波器<br>截止频率为30MHz左右的低通滤波器<br>中心频率为30MHz左右的带通滤波器<br>截止频率为300MHz左右的低通滤波器	截止频率为30MHz左右的低通滤波器
LK0574 假设中继台的收、发信机共用天线，上下行频率分别为F1和F2。要防止中继台发射机对接收机产生干扰，应该对中继台设备采取下列措施：<br>在发信机与天线间串联中心频率为F2的带阻滤波器，在收信机与天线间串接中心频率为F2的带阻滤波器<br>在发信机与天线间串联中心频率为F1的带通滤波器，在收信机与天线间串接中心频率为F2的带通滤波器<br>在发信机与天线间串联中心频率为F1的带阻滤波器，在收信机与天线间串接中心频率为F1的带阻滤波器<br>在发信机与天线间串联中心频率为F1的带阻滤波器，在收信机与天线间串接中心频率为F2的带阻滤波器	在发信机与天线间串联中心频率为F1的带阻滤波器，在收信机与天线间串接中心频率为F2的带阻滤波器
LK0575 要防止业余HF发射机的杂散发射干扰天线附近的电话机，应该在电话机和电话线之间之间串联：<br>中心频率约为3kHz的带通滤波器<br>截止频率约为3kHz的带阻滤波器<br>截止频率约为3kHz的高通滤波器<br>截止频率不高于1MHz的低通滤波器	截止频率不高于1MHz的低通滤波器
LK0576 A、B两部HF业余电台相距很近，分别工作在A、B两个频段。为减少B电台受到来自A电台的干扰，可以在B电台与天线之间串联：<br>中心频率为A的带通滤波器<br>截止频率为A的高通滤波器<br>中心频率为A的带阻滤波器<br>截止频率为B的高通滤波器	中心频率为A的带阻滤波器
LK0577 电阻元件的“额定功率”参数是指：<br>该元件正常工作时所需要的最小功率<br>该元件正常工作时必须正好消耗的功率<br>该元件正常工作时所能承受的最大功率<br>该元件接入任何电路时的实际消耗功率	该元件正常工作时所能承受的最大功率
LK0578 电阻的色环从靠近边缘的一个数起，分别为棕、橙、橙、黑，其阻值为：<br>3700欧<br>13千欧<br>250欧<br>4.7兆欧	13千欧
LK0579 电阻的色环从靠近边缘的一个数起，分别为黄、白、红、银，其阻值为：<br>4.7兆欧<br>49千欧<br>4900欧<br>390千欧	4900欧
LK0580 电阻的色环从靠近边缘的一个数起，分别为棕、橙、橙、黑、银，其阻值为：<br>133欧<br>4.7兆欧<br>130千欧<br>13千欧	133欧
LK0581 电阻的色环分别依次为金、红、黑、灰、橙，其阻值为：<br>2070欧<br>28千欧<br>38000欧<br>208千欧	38000欧
LK0582 电阻的色环分别依次为金、棕、黑、白、黄，其阻值为：<br>1090千欧<br>4900欧<br>109千欧<br>190千欧	4900欧
LK0583 把一个电感值为100微亨的线圈跨接在电路上，不致严重妨碍原电路工作或造成安全危险的是：<br>跨接在220伏交流电源插座两端<br>跨接在HF收发信机天线插座两端<br>跨接在输出阻抗为600欧的音响信号线两端<br>跨接在12伏蓄电池两端	跨接在HF收发信机天线插座两端
LK0584 把一个电容量为1000微法的电容器跨接在电路上，不致严重妨碍原电路工作或造成安全危险的是：<br>跨接在220伏交流电源插座两端<br>跨接在输出阻抗为600欧的音响信号线两端<br>跨接在12伏蓄电池两端<br>跨接在HF收发信机天线插座两端	跨接在12伏蓄电池两端
LK0585 在射频电路分析中，能产生信号频率以外的新频率分量的元器件属于有源元器件，可能成为形成干扰的重要环节。下列元器件中属于有源元器件的有：<br>宽带变压器<br>电解电容器<br>半导体二极管<br>碱性干电池	半导体二极管
LK0586 在射频电路分析中，能产生信号频率以外的新频率分量的元器件属于有源元器件，可能成为形成干扰的重要环节。下列元器件中属于有源元器件的有：<br>电阻假负载<br>晶体滤波器<br>半导体三极管<br>可调电感器	半导体三极管
LK0587 现代无线电电路大量应用表面装焊元器件（Surface Mounted Devices）。其规格参数0402、0603、0805、1206等是指：<br>电感值（单位：微亨）<br>元器件的长和宽（以单位：毫米或0.1英寸）<br>电阻值（单位：千欧）<br>容量值（单位：微法）	元器件的长和宽（以单位：毫米或0.1英寸）
LK0588 业余无线电收发信机所用的半导体器件经常会在型号或者使用说明中用一组字母加以描述，例如 SIP、DIP、SOT、SOP、SSOP、QFP等，它们用来说明：<br>器件的封装形式<br>器件的工作频率范围<br>器件的工作温度范围<br>器件的输入输出电平范围	器件的封装形式
LK0589 在业余收发信机的常见元器件中，标有耐压指标的是：<br>电感<br>电容<br>熔丝<br>电阻	电容
LK0590 在业余收发信机的常见元器件中，以额定耗散功率指标分类的是：<br>电阻<br>熔丝<br>电感<br>电容	电阻
LK0591 在业余收发信机的常见元器件中，标有额定电流指标的是：<br>电感<br>电阻<br>电容<br>熔丝	熔丝
LK0592 在业余收发信机电路中，经常用于隔直流或者给交流信号提供旁路的元件是：<br>半导体开关器件<br>电容<br>电感<br>电阻	电容
LK0593 在业余收发信机电路中，经常用谐振回路来筛选一定频率的信号。组成谐振回路的主要元器件是：<br>电感和电阻的组合<br>半导体三极管和电阻的组合<br>电容和电感的组合<br>电阻和电容的组合	电容和电感的组合
LK0594 下列电路具备的功能是：<br><img src="LK0594.jpg"><br>带通滤波<br>高通滤波<br>低通滤波<br>过流保护	低通滤波
LK0595 下列电路具备的功能是：<br><img src="LK0595.jpg"><br>过流保护<br>带通滤波<br>低通滤波<br>高通滤波	低通滤波
LK0596 下列电路具备的功能是：<br><img src="LK0596.jpg"><br>带通滤波<br>低通滤波<br>高通滤波<br>过流保护	低通滤波
LK0597 下列电路具备的功能是：<br><img src="LK0597.jpg"><br>带通滤波<br>低通滤波<br>高通滤波<br>过流保护	低通滤波
LK0598 下列电路具备的功能是：<br><img src="LK0598.jpg"><br>过流保护<br>带通滤波<br>低通滤波<br>高通滤波	低通滤波
LK0599 下列电路具备的功能是：<br><img src="LK0599.jpg"><br>带通滤波<br>过流保护<br>高通滤波<br>低通滤波	高通滤波
LK0600 下列电路具备的功能是：<br><img src="LK0600.jpg"><br>过流保护<br>低通滤波<br>带通滤波<br>高通滤波	高通滤波
LK0601 下列电路具备的功能是：<br><img src="LK0601.jpg"><br>低通滤波<br>高通滤波<br>带通滤波<br>过流保护	高通滤波
LK0602 下列电路具备的功能是：<br><img src="LK0602.jpg"><br>高通滤波<br>过流保护<br>带通滤波<br>低通滤波	高通滤波
LK0603 下列电路具备的功能是：<br><img src="LK0603.jpg"><br>过流保护<br>低通滤波<br>带通滤波<br>高通滤波	高通滤波
LK0604 下列电路具备的功能是：<br><img src="LK0604.jpg"><br>低通滤波<br>带通滤波<br>高通滤波<br>过流保护	带通滤波
LK0605 下列电路是一个：<br><img src="LK0605.jpg"><br>电感三点式振荡器<br>电感耦合式振荡器<br>RC反馈式振荡器<br>电容三点式振荡器	电感耦合式振荡器
LK0606 下列电路是一个：<br><img src="LK0606.jpg"><br>电感三点式振荡器<br>电容三点式振荡器<br>电感反馈式振荡器<br>RC反馈式振荡器	电感三点式振荡器
LK0607 下列电路是一个：<br><img src="LK0607.jpg"><br>电容三点式振荡器<br>电感反馈式振荡器<br>RC反馈式振荡器<br>电感三点式振荡器	电容三点式振荡器
LK0608 下列电路是一个：<br><img src="LK0608.jpg"><br>电容三点式振荡器<br>RC反馈式振荡器<br>电感三点式振荡器<br>电感反馈式振荡器	RC反馈式振荡器
LK0609 下列电路是一个：<br><img src="LK0609.jpg"><br>RC反馈式振荡器<br>电感反馈式振荡器<br>电容三点式振荡器<br>电感三点式振荡器	电容三点式振荡器
LK0610 下列电路是一个：<br><img src="LK0610.jpg"><br>二极管半波整流器<br>二极管环形调制器<br>二极管桥式整流器<br>二极管全波整流器	二极管半波整流器
LK0611 下列电路是一个：<br><img src="LK0611.jpg"><br>二极管全波整流器<br>二极管半波整流器<br>二极管环形调制器<br>二极管桥式整流器	二极管桥式整流器
LK0612 下列电路是一个：<br><img src="LK0612.jpg"><br>二极管全波整流器<br>二极管环形调制器<br>二极管半波整流器<br>二极管桥式整流器	二极管全波整流器
LK0613 下列电路是一个：<br><img src="LK0613.jpg"><br>二极管桥式整流器<br>二极管环形调制器<br>二极管全波整流器<br>二极管半波整流器	二极管环形调制器
LK0614 图示电路为业余无线电爱好者常用的简易场强表。各部件的作用分别为：<br><img src="LK0614.jpg"><br>A-整流，C1、C2-隔直流，L-放大，D-滤波，C3-谐振，M-指示<br>A-接收电波，C1、C2旁路滤波，L-升压，D-放大，C3-隔直流，M-指示<br>A-接收电波，C1、C2高频旁路，L-放大，D-开关，C3-耦合，M-指示<br>A-接收电波，C1、C2、L-谐振选频，D-检波，C3-旁路滤波，M-指示	A-接收电波，C1、C2、L-谐振选频，D-检波，C3-旁路滤波，M-指示
LK0615 将电阻R和电容C串联后突然接到直流电压U上，电容C两端的电压会：<br>从U按指数规律逐渐减小到0<br>从U突然跳到0，然后再按指数规律逐渐增大到U<br>从0突然跳到U，然后再按指数规律逐渐减小到0<br>从0按指数规律逐渐增加到U	从0按指数规律逐渐增加到U
LK0616 将电阻R和电容C串联后突然接到直流电压U上，电容C两端的电压在经过时间常数T后大约会达到U的：<br>6.28%<br>37%<br>99%<br>63%	63%
LK0617 将电阻R和电容C串联后突然接到直流电压U上，电阻R两端的电压会：<br>从U突然跳到0，然后再按直线规律逐渐减小到U<br>从0按指数规律逐渐增加到U<br>从U按直线规律逐渐减小到0<br>从0突然跳到U，然后再按指数规律逐渐减小到0	从0突然跳到U，然后再按指数规律逐渐减小到0
LK0618 将电阻R和电容C串联后突然接到直流电压U上，电阻R两端的电压在经过时间常数T后大约会达到U的：<br>63%<br>37%<br>99%<br>6.28%	37%
LK0619 将电阻R和电容C串联后突然接到直流电压U上，流过电阻R的电流会：<br>从0突然跳到U/R，然后再按指数规律逐渐减小到0<br>从U/R突然跳到0并保持<br>从0突然跳到U/R并保持<br>从0按指数规律逐渐增加到U/R	从0突然跳到U/R，然后再按指数规律逐渐减小到0
LK0620 将电阻R和电容C串联后突然接到直流电压U上，流过电容C的电流会：<br>从0突然跳到U/R并保持<br>从0突然跳到U/R，然后再按指数规律逐渐减小到0<br>从0按指数规律逐渐增加到U/R<br>从U/R突然跳到0并保持	从0突然跳到U/R，然后再按指数规律逐渐减小到0
LK0621 电阻R和电容C并联后接在电压为U的直流电源上。突然断开电源，电容C两端的电压会：<br>从0按指数规律逐渐增加到U<br>从U按指数规律逐渐减小到0<br>从0突然跳到U并保持<br>从U突然跳到0并保持	从U按指数规律逐渐减小到0
LK0622 电阻R和电容C并联后接在电压为U的直流电源上。突然断开电源，电阻R两端的电压会：<br>从0突然跳到U并保持<br>从0按指数规律逐渐增加到U<br>从U按指数规律逐渐减小到0<br>从U突然跳到0并保持	从U按指数规律逐渐减小到0
LK0623 电阻R和电容C并联后接在电压为U的直流电源上。突然断开电源，流过电阻R的电流会：<br>从U突然跳到0，然后再按指数规律逐渐增大到U/R<br>从0按指数规律逐渐增加到U/R<br>从U/R按指数规律逐渐减小到0<br>从0突然跳到U/R，然后再按指数规律逐渐减小到0	从U/R按指数规律逐渐减小到0
LK0624 电阻R和电容C并联后接在电压为U的直流电源上。突然断开电源，流过电容C的电流会：<br>从0突然跳到U/R，然后再按指数规律逐渐减小到0<br>从U突然跳到0，然后再按指数规律逐渐增大到U/R<br>从0突然跳到U/R并保持<br>从0按指数规律逐渐增加到U/R	从0突然跳到U/R，然后再按指数规律逐渐减小到0
LK0625 将电阻R和电感L串联后突然接到直流电压U上，电感L两端的电压会：<br>从0突然跳到U，然后再按指数规律逐渐减小到0<br>从U按指数规律逐渐减小到0<br>从U突然跳到0并保持<br>从0按指数规律逐渐增加到U	从0突然跳到U，然后再按指数规律逐渐减小到0
LK0626 将电阻R和电感L串联后突然接到直流电压U上，电感L两端的电压在经过时间常数T后大约会达到U的：<br>99%<br>37%<br>6.28%<br>63%	37%
LK0627 将电阻R和电感L串联后突然接到直流电压U上，电阻R两端的电压在经过时间常数T后大约会达到U的：<br>37%<br>6.28%<br>99%<br>63%	63%
LK0628 将电阻R和电感L串联后突然接到直流电压U上，电阻R两端的电压会：<br>从0按指数规律逐渐增加到U<br>从0突然跳到U，然后再按指数规律逐渐减小到0<br>从U突然跳到0并保持<br>从U按指数规律逐渐减小到0	从0按指数规律逐渐增加到U
LK0629 将电阻R和电感L串联后突然接到直流电压U上，流过电阻R的电流会：<br>从0突然跳到U/R并保持U/R<br>从0突然跳到U/R，然后再按指数规律逐渐减小到0<br>从U/R按指数规律逐渐减小到0<br>从0按指数规律逐渐增加到U/R	从0按指数规律逐渐增加到U/R
LK0630 将电阻R和电感L串联后突然接到直流电压U上，流过电感L的电流会：<br>从0突然跳到U/R并保持<br>从0按指数规律逐渐增加到U/R<br>从0突然跳到U/R，然后再按指数规律逐渐减小到0<br>从U/R按指数规律逐渐减小到0	从0按指数规律逐渐增加到U/R
LK0631 电阻R和电感L并联后接在电流为I的直流电路中。突然断开电路，电感L两端的电压会：<br>从0按指数规律逐渐增加到I*R<br>保持在I*R<br>保持在0<br>从I*R按指数规律逐渐减小到0	从I*R按指数规律逐渐减小到0
LK0632 一个电容器，在某一频率下测得容抗为若干欧姆。如果频率提高N倍，其容抗将：<br>减少到原来的1/（2πN）<br>增大到原来的2πN倍<br>增大到原来的N倍<br>减少到原来的1/N	减少到原来的1/N
LK0633 一个电感线圈，在某一频率下测得感抗为若干欧姆。如果频率提高N倍，其感抗将：<br>增大到原来的2πN倍<br>减少到原来的1/（2πN）<br>增大到原来的N倍<br>减少到原来的1/N	增大到原来的N倍
LK0634 一个电容器，在50Hz频率下实测得容抗为100欧姆。按容抗公式计算，在5MHz时容抗应为0.001欧姆，但实测到的阻抗明显偏大。这是因为：<br>仪器的频率特性欠佳<br>电容器介质损耗造成非线性失真<br>容抗计算公式在高频率下不适用<br>电容器引线在频率变高后带来不可忽略的感抗	电容器引线在频率变高后带来不可忽略的感抗
LK0635 一个电感线圈，在50Hz频率下实测得感抗为10欧姆。按感抗公式计算，在5MHz时感抗应为1兆欧，但实测到的阻抗明显偏小。这是因为：<br>电感线圈的分布电容在频率变高后带来不可忽略的容抗<br>电感线圈导线损耗造成非线性失真<br>仪器的频率特性欠佳<br>感抗计算公式在高频率下不适用	电感线圈的分布电容在频率变高后带来不可忽略的容抗
LK0636 将继电器的线圈接在开关三极管的集电极电路中，用三极管控制继电器的通断。可能发生的现象是：<br>三极管关断的瞬间集电极可能承受远高于工作电流的电流冲击<br>三极管关断的瞬间集电极可能承受远高于电源的电压冲击<br>三极管导通的瞬间集电极可能承受远高于电源的电压冲击<br>三极管导通的瞬间集电极可能承受远高于工作电流的电流冲击	三极管关断的瞬间集电极可能承受远高于电源的电压冲击
LK0637 用开关器件控制继电器线圈的通断时，经常要在继电器线圈两端并联一个二极管或者电容，其作用是：<br>减少继电器的磨损<br>吸收继电器线圈电感在电路关断瞬间感应出的反向电动势以保护开关器件<br>消除继电器接点通断时产生的火花干扰<br>减少通过开关器件的工作电流	吸收继电器线圈电感在电路关断瞬间感应出的反向电动势以保护开关器件
LK0638 用一个电压为4.2伏的低电压电池和一堆无源电子元件做电路实验，但连接电路时感觉手不慎被高电压击了一下。可能产生这个高电压的元件是：<br>电源变压器的绕组<br>大电流高反压二极管<br>电解电容器<br>额定功率为50瓦的大电阻	电源变压器的绕组
LK0639 用继电器控制直流负载时，有时在继电器接点线圈两端并联一个电容，其作用是：<br>吸收继电器线圈电感在电路关断瞬间感应出的反向电动势以保护开关器件<br>减少继电器的磨损<br>消除继电器接点通断时产生的火花干扰<br>减少通过开关器件的工作电流	消除继电器接点通断时产生的火花干扰
LK0640 电路图中，电解电容器所标注的电容量值的缺省单位是：<br>法拉<br>皮法拉<br>毫法拉<br>微法拉	法拉
LK0641 电路图中，非电解电容器所标注的大于1的整数或小数电容量值的缺省单位是：<br>毫法拉<br>皮法拉<br>法拉<br>微法拉	皮法拉
LK0642 在电路图中或元件上，非电解电容器的容量标注为3位数字时，读取容量的方法为：<br>实际容量为该三位数字乘以1000，单位为皮法拉<br>实际容量为该三位数字除以1000，单位为法拉<br>前一位表示容量基数，第二位表示基数后面加上几个0，第三位表示误差级别，单位为皮法拉<br>前两位表示容量基数，后一位表示基数后面加上几个0，单位为皮法拉	前两位表示容量基数，后一位表示基数后面加上几个0，单位为皮法拉
LK0643 在电路图中或原件上，电阻的阻值标注为3位数字时，读阻值的方法为：<br>前一位表示阻值基数，第二位表示基数后面加上几个0，第三位表示误差级别，单位为千欧姆<br>前两位表示阻值基数，后一位表示基数后面加上几个0，单位为欧姆<br>实际阻值为该三位数字除以100，单位欧姆<br>实际阻值为该三位数字乘以100，单位欧姆欧	前两位表示阻值基数，后一位表示基数后面加上几个0，单位为欧姆
LK0644 在电路图中或元件上，电阻的阻值标注为2或3位数字和一个字母（例如8R2、27K、1M5）时，读阻值的方法为：<br>字母前的数字表示阻值基数，字母后的数字表示误差级别，字母R、K或M，分别表示单位为欧姆、千欧姆或兆欧姆<br>把字母当做小数点，和数字连在一起表示阻值基数，字母R、K或M，分别表示单位为欧姆、千欧姆或兆欧姆<br>把所有数字挑出来连在一起，再根据字母为R、K或M，分别取欧姆、千欧姆或兆欧姆为单位<br>把所有数字挑出来连在一起乘以100，单位为欧姆	把字母当做小数点，和数字连在一起表示阻值基数，字母R、K或M，分别表示单位为欧姆、千欧姆或兆欧姆
LK0645 电路图中，非电解电容器所标注的小于1的小数电容量值的缺省单位是：<br>微法拉<br>法拉<br>毫法拉<br>皮法拉	微法拉
LK0646 “电磁感应现象”是指：<br>摩擦产生的静电可以感应出直流磁场<br>足够高的电压可以产生感应磁场<br>变化的磁场可以产生感应电流<br>足够大的静止磁场可以产生感应电流	变化的磁场可以产生感应电流
LK0647 无线电技术中常遇到的术语“互感现象”是指：<br>两个元器件连接在一起时各自的阻抗对流过对方的电流产生的相互影响<br>两个部件的电压形成的电场互相叠加的现象<br>两个回路电流变化，通过磁场耦合而相互产生感应电动势的现象<br>两种不同频率的信号在空间叠加造成的干扰现象	两个回路电流变化，通过磁场耦合而相互产生感应电动势的现象
LK0648 在电容器两端施加一个正弦交流电压，则流过电容器的电流是正弦交流电流，该电流相位：<br>与电压相位相同<br>落后于电压相位90度<br>与电压相差180度<br>超前于电压相位90度	超前于电压相位90度
LK0649 使一个正弦交流电流流过电容器，则电容器两端的电压是正弦交流电压，该电压相位：<br>超前于电流相位90度<br>与电流相差180度<br>落后于电流相位90度<br>与电压相位相同	落后于电流相位90度
LK0650 在电容器两端施加一定幅度的正弦交流电压。流过电容器的电流幅度：<br>与电压和电容量都成反比<br>与电压和电容量都成正比<br>与电压成正比，与电容量成反比<br>与电容量成正比，与电压成反比	与电压和电容量都成正比
LK0651 在线圈两端施加一个正弦交流电压，则流过线圈的电流是正弦交流电流，该电流相位：<br>超前于电压相位90度<br>落后于电压相位90度<br>与电压相位相同<br>与电压相差180度	落后于电压相位90度
LK0652 使一个正弦交流电流流过线圈，则线圈两端的电压是正弦交流电压，该电压相位：<br>与电流相位相同<br>超前于电流相位90度<br>落后于电流相位90度<br>与电流相差180度	超前于电流相位90度
LK0653 在线圈两端施加一定幅度的正弦交流电压。流过线圈的电流幅度：<br>与电压和电感量都成正比<br>与电感量成正比，与电压成反比<br>与电压和电感量都成反比<br>与电压成正比，与电感量成反比	与电压成正比，与电感量成反比
LK0654 业余电台发射单边带语音信号时，附近连接在某电路上的耳机传出了模糊不清的语音。可以断定这个电路具有下列功能：<br>差拍<br>振荡<br>变频<br>检波	检波
LK0655 业余电台发射等幅波电码信号时，附近连接在某电路上的耳机传出了“嘟嘟”的音频电码声。可以断定这个电路具有下列功能：<br>检波<br>变频<br>差拍<br>振荡	差拍
LK0656 试验某电路，接通电源时，旁边的无线电收信机可以收到它发出的类似鸟叫的声音，断开电源，鸟叫声消失。可以断定这个电路具有下列功能：<br>变频<br>检波<br>差拍<br>振荡	振荡
LK0657 用收信机的AM挡接收中等强度的SSB语音信号，调谐到最佳状态，听到的将是：<br>模糊不清的类似语音的声音<br>听不到任何语音<br>正常的语音<br>差拍叫声	模糊不清的类似语音的声音
LK0658 用收信机的AM挡接收中等强度的FM语音信号，调谐到最佳状态，听到的将是：<br>模糊不清的类似语音的声音<br>正常的语音<br>听不到语音，信号越强越寂静<br>差拍叫声	听不到语音，信号越强越寂静
LK0659 用收信机的SSB挡接收中等强度的FM语音信号，调谐到最佳状态，听到的将是：<br>模糊不清的类似语音的声音<br>差拍叫声<br>正常的语音<br>听不到任何语音	差拍叫声
LK0660 用收信机的SSB挡接收中等强度的AM语音信号，调谐到最佳状态，听到的将是：<br>正常的语音<br>模糊不清的类似语音的声音<br>听不到任何语音<br>差拍叫声	正常的语音
LK0661 用收信机的FM挡接收中等强度的AM语音信号，调谐到最佳状态，听到的将是：<br>模糊不清的类似语音的声音<br>差拍叫声<br>听不到语音，有信号时噪声消失，但听不到语音<br>听不到任何语音	听不到语音，有信号时噪声消失，但听不到语音
LK0662 用收信机的FM挡接收中等强度的SSB语音信号，调谐到最佳状态，听到的将是：<br>模糊不清的类似语音的声音<br>差拍叫声<br>听不到任何语音<br>听不到语音，但噪声可能会有些变化	听不到语音，但噪声可能会有些变化
LK0663 在HF业余频段的数据通信段中，用收信机的SSB挡听到一个由两种音调交替组成的信号，这个信号的调制方式最可能属于下述种类：<br>PSK<br>FSK<br>SSTV或FAX<br>ASK	FSK
LK0664 在HF业余频段的数据通信段中，用收信机的SSB挡听到一个音调不变但又似乎不断颤动的信号，这个信号的调制方式最可能属于下述种类：<br>SSTV或FAX<br>PSK<br>FSK<br>ASK	PSK
LK0665 用收信机的SSB挡在业余频段中，听到一个音调大致以约为几分之一秒的重复周期连续变化、并夹有一种规律的“笃、笃”声的信号，。这个信号的调制方式最可能属于下述种类：<br>FSK<br>ASK<br>PSK<br>SSTV或FAX	SSTV或FAX
LK0666 无线电设备中的变压器铁芯一般都用矽钢片堆迭或采用不导电的磁性材料，而不像继电器那样采用整块铁芯。这是因为：<br>矽钢片和磁性材料比整块铁芯容易加工<br>防止交流电流在导电的铁芯内感应出涡流、造成发热损耗<br>整块铁芯容易产生机械松动<br>整块铁芯容易漏电，不利用安全	防止交流电流在导电的铁芯内感应出涡流、造成发热损耗
LK0667 同样材料、同样直径、同样长度的实心铜线和空心铜管，在交流电路中的发热损耗情况为：<br>在不同频率两者的发热损耗大小不好说，取决于具体散热条件<br>在低频率下实心铜线损耗较小，在高频率下两者损耗一样<br>在低频率下实心铜线损耗较大，在高频率下两者损耗一样<br>在各种频率下两者耗差都一样	在低频率下实心铜线损耗较小，在高频率下两者损耗一样
LK0668 把实心导线接到频率为数十兆赫兹的高频率射频电路中，则会有下列现象：<br>电流集中在导线表层，导线内部没有电流<br>表层的电流沿导线方向流动，内层电流形成螺旋状涡流<br>导线外层和内层都有电流，但两者方向相反<br>导线截面各处的电流密度均匀分布	电流集中在导线表层，导线内部没有电流
LK0669 工作在高频率下的射频部件积灰或受潮后，即使没有漏电，也可能因绝缘物体的物理变化而带来额外的：<br>涡流损耗<br>磁阻损耗<br>磁滞损耗<br>介质损耗	介质损耗
LK0670 在电感线圈中加入适当磁性材料做成的磁芯可以减少电流通过时的损耗，是因为：<br>磁芯可将原来损耗的能量反射回导线<br>磁芯比空气更容易散热，可减少线圈的发热损耗<br>加入磁芯后可用较短导线维持所需的电感量，减少导线电阻引起的发热损耗<br>加入磁性可改善导线趋肤效应引起局部电流密度增大而带来的发热损耗	加入磁芯后可用较短导线维持所需的电感量，减少导线电阻引起的发热损耗
LK0671 在电容、电感串联电路中，如果电容的容抗与电感的感抗大小相等，描述这一状态最适当的术语是：<br>谐振<br>干涉<br>叠加<br>匹配	谐振
LK0672 由电感为L的线圈、容量为C的电容组成LC谐振电路，其谐振频率f为：（L、C和f的单位分别为微亨、微法拉和兆赫, “x＾m”表示“x的m次方”）<br>f = 2π(LC)＾(1/2)<br>f = 1/((2πLC)＾2)<br>f = 1/（2π(LC)＾(1/2)）<br>f = 2π(LC)＾(1/2)	f = 1/（2π(LC)＾(1/2)）
LK0673 L和C串联后，其总阻抗为：<br>随频率增高而不断减小<br>随频率增高而不断增大<br>在谐振频率达到最小值<br>在谐振频率达到最大值	在谐振频率达到最小值
LK0674 L和C并联后，其总阻抗为：<br>在谐振频率达到最小值<br>在谐振频率达到最大值<br>随频率增高而不断减小<br>随频率增高而不断增大	在谐振频率达到最大值
LK0675 “Q值”是经常被用来描述谐振回路或者谐振天线电路的一个电气参数。它表示的是：<br>谐振回路体积或者天线尺寸与波长的比例。体积或尺寸越紧凑，Q值越高<br>谐振回路中信号的能量损耗情况。损耗越小，Q值越高<br>谐振回路或者天线所耐受的最大功率。耐受功率越大，Q值越高<br>谐振回路或者天线所能正常工作的最高频率。工作频率上限越高， Q值越高	谐振回路中信号的能量损耗情况。损耗越小，Q值越高
LK0676 根据谐振回路或者谐振天线电路Q值的高低可以做出如下判断：<br>Q值越高，谐振曲线越尖锐，选择性越好，通带宽度越窄<br>Q值越高，谐振曲线越平坦，选择性越不明显，通带宽度越宽<br>Q值越高，回路或天线的工作频率越高<br>Q值越高，回路或天线的工作状态受频率变化的影响越小	Q值越高，谐振曲线越尖锐，选择性越好，通带宽度越窄
LK0677 谐振回路的通带宽度BW是指：<br>回路两端电压信号幅度从中心频率衰减80%时上、下限频率的间距<br>回路两端电压信号幅度从中心频率衰减30%时上、下限频率的间距<br>回路两端电压信号幅度从中心频率衰减3dB时上、下限频率的间距<br>回路两端电压信号幅度从中心频率衰减95%时上、下限频率的间距	回路两端电压信号幅度从中心频率衰减3dB时上、下限频率的间距
LK0678 滤波器的“截止频率”是指：<br>低于该频率的信号将被滤波器完全切除<br>高于该频率的信号将被滤波器完全切除<br>输出频率特性曲线从通带的0dB变化到-3dB的频率<br>高于该频率的信号将会在滤波器中发生非线性失真	输出频率特性曲线从通带的0dB变化到-3dB的频率
LK0679 滤波器的“3dB带宽”是指：<br>滤波器维持3dB增益的频率比范围宽度<br>输出信号相对于输入信号衰减3dB以下（含3dB）的频率范围宽度<br>输出信号相对于输入信号衰减3dB以上（含3dB）的频率范围宽度<br>输出频率特性曲线从通带的0dB变化到-3dB的频率之间的宽度	输出频率特性曲线从通带的0dB变化到-3dB的频率之间的宽度
LK0680 滤波器有一个称为“通带波动”的参数，是指：<br>滤波器因元器件不稳定等随机原因使输出信号幅度发生上下波动的现象<br>通带范围内衰减因频率不同的变化幅度<br>滤波器频率特性在整个频谱范围内的变化趋势<br>等幅信号通过滤波器时幅度发生抖动的现象	通带范围内衰减因频率不同的变化幅度
LK0681 比较考究的接收机说明书中常列出一项“通带矩形系数”或“通带形状系数”的指标，是用来描述：<br>通带滤波器频率特性曲线斜坡的陡峭程度<br>矩形波信号通过接收机所产生的延迟时间<br>通带滤波器对矩形波信号的通过能力<br>通带晶体滤波器中石英晶片的形状和切割方式	通带滤波器频率特性曲线斜坡的陡峭程度
LK0682 根据说明书列出的技术指标，两台业余无线电接收机在USB方式下选择带宽为2.7kHz的滤波器时具有不同的“通带矩形系数”。接收机A的“60dB带宽对6dB带宽的矩形系数”为3.8，接收机B的 为5。由此可作出推论：<br>A机对邻近频道干扰的抑制能力比B机差<br>A机对镜像频道干扰的抑制能力比B机强<br>A机对邻近频道干扰的抑制能力比B机强<br>A机对偏离工作频率±10kHz以外的干扰信号的抑制能力比B机强	A机对邻近频道干扰的抑制能力比B机强
LK0683 根据说明书列出的技术指标，两台业余无线电接收机的“通带波动”分别为1dB和3dB。由此可作出推论：<br>A机对通道内信号的频率响应不如B机平坦<br>A机对通道内信号的频率响应比B机平坦<br>A机的通带增益的可调范围比B机小<br>A机接收到的信号的幅度颤动比B机小	A机对通道内信号的频率响应比B机平坦
LK0684 业余无线电技术描述收信机预选滤波电路和发信机输出滤波电路时，经常会提到LC滤波器的“阶数”或“极点数”。确定LC滤波器阶数的简单办法是：<br>滤波电路中电感元件的总个数减去电容元件的总个数，即得阶数<br>滤波电路中分叉节的数量即为阶数<br>滤波电路中分叉节的数量减1即为阶数<br>先合并简化串、并联的电容元件或串、并联的电感元件，得到的电容元件和电感元件总个数即为阶数	先合并简化串、并联的电容元件或串、并联的电感元件，得到的电容元件和电感元件总个数即为阶数
LK0685 为了减少发射设备的谐波干扰近在咫尺的接收机，可以在发射设备和天线之间串联一个LC低通滤波器。正确的说法是：<br>滤波器的阶数越高，抑制倍频干扰的效果越好<br>滤波器的阶数越低，抑制倍频干扰的效果越好<br>滤波器的阶数越高，耐受的功率越大<br>滤波器的阶数越高，损耗的功率越小	滤波器的阶数越高，抑制倍频干扰的效果越好
LK0686 无线电发射设备参数和业余无线电原理书籍中经常出现缩写为ppm的度量单位。其中文含义和最经常的用处是：<br>“每分钟平均脉冲数”，常用于描述单个脉冲的出现次数<br>“每分钟点数”，常用于描述随机干扰的出现次数<br>“每分钟点数”，常用于描述太阳黑子的发生频度<br>“百万分比”，常用于描述频率的相对稳定度	“百万分比”，常用于描述频率的相对稳定度
LK0687 用SSB接收机的天线引线靠近一个晶体管LC振荡器电路板，接收其信号。振荡器电路接通电源后，发现收到的信号音调会从低到高或者从高到低变化。这主要因为：<br>随着射频能量泄露，电路的输出功率下降<br>半导体晶体管处于老化过程<br>接收机的声音能量反馈到电路板引起<br>元器件通电发热，引起相关LC参数变化，造成谐振频率漂移	元器件通电发热，引起相关LC参数变化，造成谐振频率漂移
LK0688 在无线电电路中常用于产生基准频率的元件中，按频率稳定度由低到高的排列为：<br>LC回路，RC定时电路，陶瓷谐振器，石英声表面波元件，石英晶体谐振器<br>RC定时电路，陶瓷谐振器，LC回路，石英晶体谐振器，石英声表面波元件<br>RC定时电路，LC回路，石英声表面波元件，石英晶体谐振器，陶瓷谐振器<br>RC定时电路，LC回路，陶瓷谐振器，石英声表面波元件，石英晶体谐振器	RC定时电路，LC回路，陶瓷谐振器，石英声表面波元件，石英晶体谐振器
LK0689 在给业余收发信机供电的整流电源中，开关电源可以做得比变压器直接降压整流的线性电源轻巧是因为：<br>开关电源使用轻质铝材做散热器，不需要通过笨重的铁芯变压器散热<br>开关电路中半导体元器件的损耗小，可以使用轻巧的小规格元器件<br>开关电源中变压器的工作频率高得多，可以缩小磁性材料截面和减少线圈匝数<br>开关电源使用了半导体器件，不需要变压器	开关电源中变压器的工作频率高得多，可以缩小磁性材料截面和减少线圈匝数
LK0690 220V.AC/13.8V.DC通信开关电源的一般工作过程是：<br>由大功率半导体三极管将交流输入变为高压直流，由专用集成电路变成超音频脉冲电流，经整流滤波为低压直流<br>将交流输入整流滤波为高压直流，由半导体开关电路变成高压脉冲电流，由变压器变成低压脉冲，整流滤波为低压直流<br>将交流输入整流滤波为高压直流，由变压器变成低压脉冲，由半导体开关电路变成低压直流，滤波后输出<br>由变压器将交流输入变为低压交流，由半导体开关电路变成超音频脉冲电流，经整流滤波为低压直流	将交流输入整流滤波为高压直流，由半导体开关电路变成高压脉冲电流，由变压器变成低压脉冲，整流滤波为低压直流
LK0691 通信或家用设备的劣质开关电源会造成对无线电接收机的电磁干扰，其源头主要是：<br>开关电源中整流电路的滤波电容容量不足<br>元器件接点不稳造成火花放电干扰<br>开关电路的谐波辐射<br>工频电源变压器漏磁感应	开关电路的谐波辐射
LK0692 高档无线电通信设备的说明书经常会出现缩写TCXO或OCXO。它们是分别指：<br>通信模式自动识别功能、干扰信号自动抵消功能<br>超低温前置射频放大器、超线性射频功率放大器<br>温度补偿式晶体振荡器、恒温控制式晶体振荡器<br>中频数字信号处理部件、音频数字信号处理部件	温度补偿式晶体振荡器、恒温控制式晶体振荡器
LK0693 无线电原理经常用到缩写VFO，它代表：<br>压控振荡器<br>可变频率石英振荡器<br>石英晶体元件<br>可变频率振荡器	可变频率振荡器
LK0694 无线电原理经常用到缩写VXO，它代表：<br>可变频率振荡器<br>石英晶体元件<br>压控振荡器<br>可变石英振荡器	可变石英振荡器
LK0695 无线电原理经常用到缩写VCO，它代表：<br>可变频率振荡器<br>石英晶体元件<br>可变石英振荡器<br>压控振荡器	压控振荡器
LK0696 无线电原理经常用到缩写XTAL，它代表：<br>石英晶体元件<br>压控振荡器<br>可变频率振荡器<br>晶体振荡器	石英晶体元件
LK0697 构成振荡器的必备元素是：<br>放大倍数大于1的放大器、负反馈电路<br>放大倍数大于1的放大器、正反馈电路<br>任意放大器、LC或晶体谐振电路<br>LC或晶体谐振电路、正反馈电路	放大倍数大于1的放大器、正反馈电路
LK0698 有些无线电收发信机在外接13.8V直流电源插座后正向串联一个大电流二极管作为保护。所利用的二极管的特性和动作原理为：<br>二极管的单向导电特性；在接反电源极性时自动阻断电源<br>大电流二极管的散热性能；帮助电路发散热量，防止设备过热<br>二极管导电区的非线性；在设备电流超限时加大压降，起到限流作用<br>二极管导电区的非线性；在电源过压时加大压降，起到稳压作用	二极管的单向导电特性；在接反电源极性时自动阻断电源
LK0699 有些无线电收发信机在外接13.8V直流电源插座后串联一个熔断器，并在电源线的设备端反向跨接一个大电流二极管作为保护。所利用的二极管的特性和动作原理为：<br>大电流二极管的散热性能；帮助电路发散热量，防止设备过热<br>二极管的单向导电特性；接反电源极性时造成很大短路电路，烧断熔丝，造成电源永久切断<br>二极管导电区的非线性；在电源过压时加大压降，起到稳压作用<br>二极管导电区的非线性；在设备电流超限时加大压降，起到限流作用	二极管的单向导电特性；接反电源极性时造成很大短路电路，烧断熔丝，造成电源永久切断
LK0700 用一副臂长约10cm的小偶极天线并联一个半导体二极管和直流微安表，做一个简单的天线场强表。应选用硅二极管还是锗二极管，正确的考虑是：<br>电路过于简单，无论使用锗、硅二极管，都无法工作<br>所有二极管都具有同样的单向导电特性，采用锗、硅二极管效果完全相同<br>锗、硅二极管的起始导通电压分别为0.3和0.7V，应选用锗二极管使场强表比较灵敏<br>硅二极管反向击穿电压比较高，应选用硅管使场强表延长使用寿命	锗、硅二极管的起始导通电压分别为0.3和0.7V，应选用锗二极管使场强表比较灵敏
LK0701 无线电发射设备和市电网的发电机都属于交流电源。接到无线电发射设备的平行导线上可能会出现电压和电流的驻波，造成各处电压不同，而接到市电网上的电线却看不到这种现象。原因是：<br>无线电设备所接的馈线和市电网用的电线性能不同，所以现象不同<br>市电网的发电能力远大于无线电发射设备，致使电路各处电压恒定<br>市电频率很低，导线长度的差别与波长相比微不足道，驻波现象很不明显而已<br>供电工程和无线电工程所适用的电学理论基础不相同	市电频率很低，导线长度的差别与波长相比微不足道，驻波现象很不明显而已
LK0702 由半波长偶极天线和馈电电缆构成的天馈系统，理想的工作状态是：<br>天线上只有行波，馈线上只有驻波<br>天线和馈线上都只有行波<br>天线和馈线上都只有驻波<br>天线上只有驻波，馈线上只有行波	天线上只有驻波，馈线上只有行波
LK0703 接收月面反射通信等VHF/UHF微弱信号时常需要在八木天线端加接加接低噪声前置放大器，而HF频段通信很少在八木天线端加装前置放大器。这是因为：<br>VHF/UHF频段信号微弱，在天线端放大可减少电缆固有噪声影响；HF频段环境背景噪声电平高，电缆固有噪声可以忽略<br>在HF频段的八木天线体积较大，把放大器安装得太近容易引起自激<br>电缆固有噪声只产生在VHF/UHF频段<br>HF频段的放大器体积太大，不适合于安装在天线端	VHF/UHF频段信号微弱，在天线端放大可减少电缆固有噪声影响；HF频段环境背景噪声电平高，电缆固有噪声可以忽略
LK0704 某业余通信接收机的中频滤波器带宽有100Hz、400Hz、2.7kHz和6kHz几挡选择。如果要为接收SSB、AM、PSK31和CW方式的信号分别从中选择合适的挡位，应该依次为：<br>2.7kHz、100Hz、6kHz、400Hz<br>2.7kHz、400Hz、6kHz、100Hz<br>2.7kHz、6kHz、100Hz、400Hz<br>6kHz、2.7kHz、400Hz、100Hz	2.7kHz、6kHz、100Hz、400Hz
LK0705 频率为f1、f2的两个正弦交流信号流过一个非线性元件，会发生“混频”。混频产物中属于三阶互调的干扰信号的频率是：<br>f1±f2、2f1±2f2、3f1±3f2<br>4f1±f2、5f1±2f2、6f1±3f2……<br>2f1、3f1、2f2、3f2<br>2f1±f2、2f2±f1	2f1±f2、2f2±f1
LK0706 “差拍”现象是指：<br>凡是接收机收到的连续音频叫声都叫做“差拍”<br>发射机用以调制载波的连续音频信号<br>两个不同频率信号经过非线性电路得到频率为两者之差的新频率信号<br>一个单频率信号经过非线性电路得到一系列谐波信号，相邻信号之间的频率差等于单频信号的频率。这样一族谐波信号的集合总称“差拍”	两个不同频率信号经过非线性电路得到频率为两者之差的新频率信号
LK0707 可以作为倍频器的电路是：<br>谐振频率等于倍频的石英晶体谐振器<br>非线性电路<br>调谐在倍频上的LC谐振电路<br>甲类放大电路	非线性电路
LK0708 一个语音信号，经过USB发射机调制成为一个射频信号。从频率域的观点看，上边带调制的过程是发生了：<br>频谱的反转（倒置）<br>频谱各分量相对幅度的有规律变化<br>频谱的简单平移<br>频谱分量完全打乱后重新组合	频谱的简单平移
LK0709 一个CW电报信号在频谱仪上显示为：<br>两条水平直线<br>一条正弦波曲线<br>一条闪动的垂直线<br>一条固定的直线	一条闪动的垂直线
LK0710 一个RTTY信号在频谱仪上显示为：<br>一条垂直线<br>一条正弦波曲线<br>两条闪动的垂直线<br>一条复杂的周期性曲线	两条闪动的垂直线
LK0711 一个SSB话音信号在频谱仪上显示为：<br>一组随语音出现和变化的非对称垂直线<br>一条随语音闪烁的直线<br>一条复杂的周期性曲线<br>一条固定的直线	一组随语音出现和变化的非对称垂直线
LK0712 一个AM话音信号在频谱仪上显示为：<br>一条随语音闪烁的直线<br>一条固定的垂直线，左右伴随一组对称的随语音出现和变化的垂直线<br>一条复杂的周期性曲线<br>多条固定的直线	一条固定的垂直线，左右伴随一组对称的随语音出现和变化的垂直线
LK0713 一个FM话音信号在频谱仪上显示为：<br>一条复杂的周期性曲线<br>一条固定的垂直线，左右伴随一组对称的随语音出现和变化的垂直线<br>多条固定的直线<br>一条随语音闪烁的直线	一条固定的垂直线，左右伴随一组对称的随语音出现和变化的垂直线
LK0714 一个PSK31信号在频谱仪上显示为：<br>一条固定的直线，左右伴随一组对称的随语音变化的直线<br>一条复杂的周期性曲线<br>一条固定的垂直线<br>多条固定的直线	一条固定的垂直线
LK0715 下列几种图表中，最容易用来表达和解释PSK调制原理的是：<br>相位矢量图<br>波形图<br>频谱图<br>频谱瀑布图	相位矢量图
LK0716 下列几种图表中，最容易用来表达和解释模拟FM调制原理的是：<br>频谱图<br>星座图和眼图<br>相位矢量图<br>波形图	频谱图
LK0717 下列几种图表中，最容易用来表达和解释SSB调制原理的是：<br>频谱瀑布图<br>相位矢量图<br>波形图<br>频谱图	频谱图
LK0718 下列几种图表中，最容易用来表达和解释RTTY调制原理的是：<br>相位矢量图<br>功率-时间曲线<br>波形图<br>频率-时间曲线	频率-时间曲线
LK0719 下列几种图表中，最容易用来表达和解释SSTV调制原理的是：<br>频率-时间曲线<br>相位矢量图<br>波形图<br>功率-时间曲线	频率-时间曲线
LK0720 下列几种图表中，最容易用来表达和解释A、B、C类放大器工作点的差别的是：<br>波形图<br>频谱图<br>相位矢量图<br>频谱瀑布图	波形图
LK0721 下列几种图表中，最容易用来表达和解释A、B、C类放大器工作点的差别的是：<br>频率-时间曲线<br>功率-时间曲线<br>输入阻抗特性曲线<br>输入-输出特性曲线	输入-输出特性曲线
LK0722 下列几种图表中，最容易用来表达和解释LC振荡器温度漂移程度的是：<br>相位矢量图<br>频谱瀑布图<br>波形图<br>频谱图	频谱瀑布图
LK0723 将发光二极管接到直流电源上时的注意点是：<br>正向无所谓，但需并联限流电阻<br>正向连接，需串联限流电阻<br>反向连接，需串联限流电阻<br>正向直接连接到电源上	正向连接，需串联限流电阻
LK0724 三极电子管至少应有几个引出电极？<br>2个<br>5个<br>4个<br>3个	4个
LK0725 三极电子管的放大作用表现在：<br>较小的阴极电流变化就可以引起较大的屏极电压的成比例变化<br>较小的栅极信号电流变化可以引起较大的屏极电流的成比例变化<br>较小的栅极信号电压变化可以引起较大的屏极电流的成比例变化<br>较小的栅极信号电流变化可以引起较大的屏极电压的成比例变化	较小的栅极信号电压变化可以引起较大的屏极电流的成比例变化
LK0726 场效应半导体管的放大作用表现在：<br>较小的栅极信号电流变化可以引起较小的漏极电流的成比例变化<br>较小的栅极信号电流变化可以引起较大的漏极电流的成比例变化<br>较小的源极信号电流变化可以引起较大的漏极电压的成比例变化<br>较小的栅极信号电压变化可以引起较大的漏极电流的成比例变化	较小的栅极信号电压变化可以引起较大的漏极电流的成比例变化
LK0727 双极型半导体管的放大作用表现在：<br>较小的发射极信号电流变化可以引起较大的集电极电流的成比例变化<br>较小的基极信号电流变化可以引起较大的集电极电流的成比例变化<br>较小的基极信号电压变化可以引起较大的集电极电压的成比例变化<br>较小的基极信号电压变化可以引起较大的集电极电流的成比例变化	较小的基极信号电流变化可以引起较大的集电极电流的成比例变化
LK0728 描述三极电子管放大能力的最常用参数、单位及符号是：<br>互导（跨导）； 单位为“倍”；符号为“A”<br>电流放大倍数；没有单位量纲；符号为“β”<br>电压放大倍数；没有单位量纲；符号为“k”<br>互导（跨导）； 单位为毫安/伏；符号为“gm”	互导（跨导）； 单位为毫安/伏；符号为“gm”
LK0729 描述场效应半导体三极管放大能力的最常用参数、单位及符号是：<br>电压放大倍数；没有单位量纲；符号为“k”<br>互导（跨导）； 单位为“倍”；符号为“A”<br>电流放大倍数；没有单位量纲；符号为“β”<br>互导（跨导）；； 单位为毫安/伏；符号为“gm”	互导（跨导）；； 单位为毫安/伏；符号为“gm”
LK0730 描述双极型半导体三极管放大能力的最常用参数、单位及符号是：<br>电压放大倍数；没有单位量纲；符号为“k”<br>互导（跨导）； 单位为“倍”；符号为“A”<br>电流放大倍数；没有单位量纲；符号为“β”<br>互导（跨导）； 单位为毫安/伏；符号为“gm”	电流放大倍数；没有单位量纲；符号为“β”
LK0731 按输入阻抗由低到高排列为：<br>双极型半导体三极管、金属绝缘栅场效应三极管、结型场效应三极管<br>金属绝缘栅场效应三极管、双极型半导体三极管、结型场效应三极管<br>结型场效应三极管、双极型半导体三极管、金属绝缘栅场效应三极管<br>双极型半导体三极管、结型场效应三极管、金属绝缘栅场效应三极管	双极型半导体三极管、结型场效应三极管、金属绝缘栅场效应三极管
LK0732 小信号放大器是指：<br>输入信号电压幅度始终小于10毫伏的放大器<br>工作点始终处于线性工作区的放大器<br>增益不超过30dB的放大器<br>输出信号电压幅度始终小于10伏的放大器	工作点始终处于线性工作区的放大器
LK0733 大信号放大器是指：<br>增益超过30dB的放大器<br>输入信号电压最大幅度大于10毫伏的放大器<br>输出信号电压最大幅度大于10伏的放大器<br>工作点可以超出线性工作区的放大器	工作点可以超出线性工作区的放大器
LK0734 图中的电路为：<br><img src="LK0734.jpg"><br>共基极放大器<br>共栅极放大器<br>共集电极放大器<br>共发射极放大器	共基极放大器
LK0735 图中的电路为：<br><img src="LK0735.jpg"><br>共发射极放大器<br>共源极放大器<br>共集电极放大器<br>共基极放大器	共发射极放大器
LK0736 图中的电路为：<br><img src="LK0736.jpg"><br>共基极放大器<br>共漏极放大器<br>共发射极放大器<br>共集电极放大器	共集电极放大器
LK0737 半导体三极管放大器的输入阻抗由低到高的排列为：<br>共集电极放大器、共发射极放大器、共基极放大器<br>共栅极放大器、共源极放大器、共漏极放大器<br>共基极放大器、共发射极放大器、共集电极放大器<br>共发射极放大器、共集电极放大器、共基极放大器	共基极放大器、共发射极放大器、共集电极放大器
LK0738 半导体三极管放大器的电流放大倍数由低到高的排列为：<br>共源极放大器、共漏极放大器、共栅极放大器<br>共发射极放大器、共集电极放大器、共基极放大器<br>共基极放大器、共发射极放大器、共集电极放大器<br>共集电极放大器、共发射极放大器、共基极放大器	共基极放大器、共发射极放大器、共集电极放大器
LK0739 工作在HF频段的电子管射频线性功率放大器多采用共栅极放大电路，这是因为共栅极放大电路： <br>输入阻抗低，栅极接地进一步阻断输入输出的极间电容耦合，因此工作稳定，不易自激 <br>共栅极放大电路的非线性失真最小<br>共栅极放大电路的输入阻抗最高，同样的信号电流可得到较大的输入电压<br>共栅极放大电路的电压放大倍数最大	输入阻抗低，栅极接地进一步阻断输入输出的极间电容耦合，因此工作稳定，不易自激 
LK0740 在下面的三极管放大电路中，Rc的常用名称和作用是：<br><img src="LK0740.jpg"><br>发射极负反馈电阻，稳定直流工作点<br>偏流电阻，为晶体管提供偏置电流以工作在适当工作点<br>集电极负反馈电阻，提供负反馈，减少信号失真<br>负载电阻，将集电极信号电流转换为信号电压	负载电阻，将集电极信号电流转换为信号电压
LK0741 在下面的三极管放大电路中，Re的常用名称和作用是：<br><img src="LK0741.jpg"><br>偏流电阻，为晶体管提供偏置电流以工作在适当工作点<br>负载电阻，将集电极信号电流转换为信号电压<br>负载电阻，将发射极信号电流转换为信号电压<br>发射极负反馈电阻，稳定直流工作点	发射极负反馈电阻，稳定直流工作点
LK0742 在下面的三极管放大电路中，Rb1的常用名称和作用是：<br><img src="LK0742.jpg"><br>发射极负反馈电阻，稳定直流工作点<br>负载电阻，将输入信号电流转换为信号电压<br>偏流电阻，为晶体管提供偏置电流以工作在适当工作点<br>基极负反馈电阻，提供负反馈，减少信号失真	偏流电阻，为晶体管提供偏置电流以工作在适当工作点
LK0743 在下面的三极管放大电路中，Cb的常用名称和作用是：<br><img src="LK0743.jpg"><br>输入耦合（或隔直流）电容，使输入交流信号电流进入放大器但阻隔直流电流分量出入<br>负反馈电容，提供负反馈，减少信号失真<br>输出耦合（或隔直流）电容，使输出交流信号顺利输出但阻隔直流分量电流出入<br>旁路电容，使发射极交流信号电流分量顺利通过，不致在Re造成压降形成负反馈	输入耦合（或隔直流）电容，使输入交流信号电流进入放大器但阻隔直流电流分量出入
LK0744 在下面的三极管放大电路中，Ce的常用名称和作用是：<br><img src="LK0744.jpg"><br>旁路电容，使发射极交流信号电流分量顺利通过，不致在Re造成压降形成负反馈<br>输出耦合（或隔直流）电容，使输出交流信号顺利输出但阻隔直流分量电流出入<br>负反馈电容，提供负反馈，减少信号失真<br>输入耦合（或隔直流）电容，使输入交流信号电流进入放大器但阻隔直流电流分量出入	旁路电容，使发射极交流信号电流分量顺利通过，不致在Re造成压降形成负反馈
LK0745 在下面的三极管放大电路中，Cc的常用名称和作用是：<br><img src="LK0745.jpg"><br>输出耦合（或隔直流）电容，使输出交流信号顺利输出但阻隔直流分量电流出入<br>负反馈电容，提供负反馈，减少信号失真<br>输入耦合（或隔直流）电容，使输入交流信号电流进入放大器但阻隔直流电流分量出入<br>旁路电容，使发射极交流信号电流分量顺利通过，不致在Re造成压降形成负反馈	输出耦合（或隔直流）电容，使输出交流信号顺利输出但阻隔直流分量电流出入
LK0746 接收机前置放大器的主要作用是：<br>提高信噪比<br>提高接收机最终的音频输出功率电平<br>改善接收机音频输出的保真度<br>改善接收机的动态范围	提高信噪比
LK0747 在EME通信等需要接收极微弱信号的场合，安装前置放大器时应做到：<br>尽量安装在远离天线的地方，放大器采用射频正反馈电路以提高增益<br>尽量安装在靠近天线的地方，信号特别微弱时对放大器冷却以降低热噪声<br>尽量安装在靠近接收机的地方，放大器最好加热以防止元器件温度过低<br>尽量安装在靠近接收机的地方，放大器尽量采用较高的电源电压以求更高的增益	尽量安装在靠近天线的地方，信号特别微弱时对放大器冷却以降低热噪声
LK0748 在无线电技术中，通常把放大器分为A、B、C、D等类别，这种分类是依据：<br>放大器件的最大输出功率<br>放大器件的工作点所处的范围<br>放大器件的质量等级<br>放大器件的最高工作频率	放大器件的工作点所处的范围
LK0749 根据放大器的工作状态，通常把放大器分为A、B、C、D等类别。A类放大器是指：<br>放大器件在半个信号周期内工作点处于线性区、另半个信号周期内处于截止区的放大器<br>放大器件在半个信号周期内处于截止区，另半个周期处于饱和区的放大器<br>放大器件在半个信号周期内处于截止区，另半个周期的部分时间候处于饱和区的放大器<br>放大器件在整个信号周期内始终工作在线性区的放大器	放大器件在整个信号周期内始终工作在线性区的放大器
LK0750 根据放大器的工作状态，通常把放大器分为A、B、C、D等类别。B类放大器是指：<br>放大器件在整个信号周期内始终工作在线性区的放大器<br>放大器件在半个信号周期内处于截止区，另半个周期处于饱和区的放大器<br>放大器件在半个信号周期内工作点处于线性区、另半个信号周期内处于截止区的放大器<br>放大器件在半个信号周期内处于截止区，另半个周期的部分时间候处于饱和区的放大器	放大器件在半个信号周期内工作点处于线性区、另半个信号周期内处于截止区的放大器
LK0751 根据放大器的工作状态，通常把放大器分为A、B、C、D等类别。C类放大器是指：<br>放大器件在半个信号周期内处于截止区，另半个周期处于饱和区的放大器<br>放大器件在整个信号周期内始终工作在线性区的放大器<br>放大器件在多于半个信号周期的时间内处于截止区，另半个周期的部分时间候处于线性区的放大器<br>放大器件在半个信号周期内工作点处于线性区、另半个信号周期内处于截止区的放大器	放大器件在多于半个信号周期的时间内处于截止区，另半个周期的部分时间候处于线性区的放大器
LK0752 根据放大器的工作状态，通常把放大器分为A、B、C、D等类别。D类放大器是指：<br>放大器件在半个信号周期内处于截止区，另半个周期的部分时间候处于饱和区的放大器<br>放大器件在整个信号周期内始终工作在线性区的放大器<br>放大器件在半个信号周期内处于截止区，另半个周期处于饱和区的放大器<br>放大器件在半个信号周期内工作点处于线性区、另半个信号周期内处于截止区的放大器	放大器件在半个信号周期内处于截止区，另半个周期处于饱和区的放大器
LK0753 A、B、C、D四类放大器按输出波形失真由小到大的排列顺序是：<br>D、C、B、A<br>A、B、C、D<br>B、A、D、C<br>A、C、B、D	A、B、C、D
LK0754 A、B、C、D四类放大器用作射频功率放大时，按电源效率由高到低的排列顺序是：<br>B、A、D、C<br>D、C、A、B<br>D、C、B、A<br>A、B、C、D	D、C、B、A
LK0755 A、B、C、D四类放大器中，可以单独用作射频线性功率放大器、但不能单独用作音频线性功率放大器的是：<br>D<br>C<br>A<br>B	B
LK0756 A、B、C、D四类放大器中，既可以单独用作射频线性功率放大器、又能单独用作音频线性功率放大器的是： （不考虑电源效率）<br>B<br>A<br>C<br>D	A
LK0757 A、B、C、D四类放大器中，可以用作FM射频功率放大器的全部类别有： （不考虑电源效率）<br>A<br>A、B、C、D<br>A、B、C<br>A、B、D	A、B、C、D
LK0758 A、B、C、D四类放大器中，可以用作CW射频功率放大器的全部类别有： （不考虑电源效率）<br>A、B、C、D<br>A<br>A、B、C<br>A、B、D	A、B、C、D
LK0759 A、B、C、D四类放大器中，适宜于做小信号放大器的是：<br>B<br>D<br>C<br>A	A
LK0760 A、B、C、D四类放大器中，属于大信号放大器的全部类别有：<br>C、D<br>A、C、D<br>A、B、C、D<br>B、C、D	B、C、D
LK0761 很多业余电台的末级和末前级射频输出放大器中采用两个并联的输出半导体功率管，这是为了：<br>构成推挽电路，减小输出波形的失真<br>双管并联，得到双倍的输出电流和输出功率<br>双管并联，得到双倍的器件耐压，减少损坏几率<br>双管并联，使每个功率管的失真互相补偿，减少失真，降低杂散发射	双管并联，得到双倍的输出电流和输出功率
LK0762 很多现代无线电设备的音频功率放大电路采用两个串联的输出半导体功率管，分别负责信号正、负半周的放大。这种电路的通用名称和作用是：<br>双管串联电路，得到较高的输出阻抗以改善与负载的阻抗匹配<br>推挽放大电路，实现极小静态工作点下的高电源效率的线性功率放大<br>双管串联电路，得到较高的输入阻抗以改善与推动级之间的阻抗匹配<br>双管串联电路，得到双倍的输出电流和输出功率	推挽放大电路，实现极小静态工作点下的高电源效率的线性功率放大
LK0763 放大器的负反馈是指这样的电路：<br>将放大器输出信号的一部分回输到放大器的输入端，起到加强输入信号的作用<br>将放大器输入信号的一部分直通到放大器的输出端，起到抵消输出信号的作用<br>将放大器输入信号的一部分直通到放大器的输出端，起到加强输出信号的作用<br>将放大器输出信号的一部分回输到放大器的输入端，起到抵消输入信号的作用	将放大器输出信号的一部分回输到放大器的输入端，起到抵消输入信号的作用
LK0764 无线电设备的放大器中大量使用了负反馈技术。与没有反馈的相比，负反馈放大器的特点是：<br>失真小，工作稳定，但增益会有所减小<br>放大倍数增大，输出信号含有的新频率分量增多<br>输出信号幅度加大，而需要的输入信号幅度减小<br>增益增大，但失真会有所增加	失真小，工作稳定，但增益会有所减小
LK0765 现代无线电通信技术大量使用数字处理技术，处理模拟信号时首先要进行模数转换。模数转换器所要求的转换速率取决于：<br>待处理信号的最高频率分量<br>待处理信号波形的复杂程度<br>待处理信号的带宽占最高频率分量的百分比<br>待处理信号的最低频率分量	待处理信号的最高频率分量
LK0766 现代无线电通信技术大量使用数字处理技术，处理模拟信号时首先要进行模数转换。模数转换器所要求的采样精度位数取决于：<br>待处理信号的最低频率分量<br>待处理信号的带宽占最高频率分量的百分比<br>待处理信号的最高频率分量<br>待处理信号波形的复杂程度	待处理信号波形的复杂程度
LK0767 在模数转换时，要使数字信号能够正确还原出原来的模拟信号，模数转换器的采样速率必须是：<br>大于信号最高频率分量的2倍<br>大于信号最高频率分量的1.2倍<br>等于信号最高频率分量<br>等于信号频率的2倍	大于信号最高频率分量的2倍
LK0768 将一个频率为f、电压最大值为U的模拟信号进行转换为数字信号。如要使数字信号能够反映出信号的相当于0.1%U的幅度细节和相当于f的8次谐波的时间细节，则模数转换器应达到如下指标：<br>采样速率大于10f，采样精度不低于9位<br>采样速率大于4f，采样精度不低于8位<br>采样速率大于16f，采样精度不低于10位<br>采样速率大于8f，采样精度不低于10位	采样速率大于16f，采样精度不低于10位
LK0769 很多现代收发信机都采用DSP技术对信号进行滤波、调制或解调等处理。其基本处理步骤是：<br>存储、数模转换、数字运算、模数转换<br>数字运算、模数转换、存储、数模转换<br>数模转换、数字运算、存储、模数转换<br>模数转换、存储、数字运算、数模转换	模数转换、存储、数字运算、数模转换
LK0770 具有两个输入的与门（AND）是最简单的数字逻辑电路之一。如果两个输入信号的组合分别为00、01、10、11，对应的输出信号应为：<br>1、0、1、0<br>0、1、1、1<br>0、0、0、1<br>0、1、0、1	0、0、0、1
LK0771 具有两个输入的或门（OR）是最简单的数字逻辑电路之一。如果两个输入信号组合分别为00、01、10、11，对应的输出信号应为：<br>0、1、1、1<br>0、1、1、0<br>1、0、1、0<br>0、1、0、1	0、1、1、1
LK0772 具有两个输入的异或门（XOR）是最简单的数字逻辑电路之一。如果两个输入信号组合分别为00、01、10、11，对应的输出信号应为：<br>0、1、1、1<br>0、1、1、0<br>0、1、0、1<br>1、0、1、0	0、1、1、0
LK0773 具有两个输入的与非门（NAND）是最简单的数字逻辑电路之一。如果两个输入信号组合分别为00、01、10、11，对应的输出信号应为：<br>1、0、1、0<br>0、1、1、1<br>1、1、1、0<br>0、1、0、1	1、1、1、0
LK0774 具有两个输入的或非门（NOR）是最简单的数字逻辑电路之一。如果两个输入信号组合分别为00、01、10、11，对应的输出信号应为：<br>0、1、1、1<br>0、1、0、1<br>1、0、1、0<br>1、0、0、0	1、0、0、0
LK0775 具有两个输入的异或非门（NXOR）是最简单的数字逻辑电路之一。如果两个输入信号组合分别为00、01、10、11，对应的输出信号应为：<br>1、0、0、1<br>0、1、1、0<br>1、1、0、0<br>0、1、1、1	1、0、0、1
LK0776 数字通信中常用到描述信号流量的“信号速率”和描述信息流量的“数据速率”两个参数。业余RTTY通信方式分别用f0和f1两个不同频率信号来传输数字0和1，最常见的每个码元的时间长度为0.02秒。其信号速率和数据速率分别为：<br>50波特，50位/秒<br>50波特，100位/秒<br>100波特，100位/秒<br>100波特，50位/秒	50波特，50位/秒
LK0777 数字通信中常用到描述信号流量的“信号速率”和描述信息流量的“数据速率”两个参数。业余BPSK通信方式中，用一个副载频f的两个相反的相位分别传输数字0和1，每个码元的时间长度约为32毫秒。其信号速率和数据速率分别为：<br>50波特，100位/秒<br>100波特，100位/秒<br>31.25波特，31.25位/秒<br>100波特，50位/秒	31.25波特，31.25位/秒
LK0778 数字通信中常用到描述信号流量的“信号速率”和描述信息流量的“数据速率”两个参数。MFK16通信方式中，用总带宽316Hz范围内的16个副载频之一来传输16种状态，信号重复频率为64毫秒。其信号速率和数据速率分别为：<br>15.625波特，15.625位/秒<br>15.625波特，250位/秒<br>15.625波特，62.5位/秒<br>62.5波特，250位/秒	15.625波特，62.5位/秒
LK0779 数字通信中常用到描述信号流量的“信号速率”和描述信息流量的“数据速率”两个参数。QPSK通信方式中，用一个副载频f的四个相差90度的相位分别传输数字00、01、10和11，每个码元的时间长度约为32毫秒。其信号速率和数据速率分别为：<br>31.25波特，31.25位/秒<br>31.25波特，62.5位/秒<br>31.25波特，125位/秒<br>50波特，100位/秒	31.25波特，62.5位/秒
LK0780 采用锁相环频率合成器的收发信机会在信号中带有附加的相位噪声，主要原因是：<br>锁相环频率合成器电路复杂，大量元器件的热噪声叠加成相位噪声<br>频率合成器的数字电路中在信号跳变时产生谐波，造成噪声<br>从检测到本振频率漂移并反馈纠正需要捕捉时间，该延迟造成本振信号相位抖动<br>频率合成器的振荡器产生非理想正弦波，带有噪声频率分量	从检测到本振频率漂移并反馈纠正需要捕捉时间，该延迟造成本振信号相位抖动
LK0781 很多现代业余无线电收发信机的本机振荡电路采用了直接数字频率合成（DDS）方式。它的主要特点是：<br>采用同样的频率源振荡器时频率稳定度优于锁相环频率合成方式<br>与锁相环频率合成方式相比，可以使用速度较低的数字元器件<br>直接产生纯净的正弦波信号，不需要采用任何滤波器<br>电路结构简洁，无锁相捕捉范围限制，不产生相位噪声，跳换频率快	电路结构简洁，无锁相捕捉范围限制，不产生相位噪声，跳换频率快
LK0782 向无线电发射机的话筒输入端施加电压幅度10倍于规定值的音频信号，可能会得到什么效果？<br>使发射功率超过额定值而烧坏发射机末级射频功率器件<br>电路失真产生谐波和互调产物，加大占用带宽，而通信效果很差<br>有效延长通信距离，使信号听起来更加饱满<br>有效延长通信距离，但信号听起来带有失真	电路失真产生谐波和互调产物，加大占用带宽，而通信效果很差
LK0783 关于是否可以在FM话音通信时单凭接收机听到对方语音的音量大小来准确判断对方信号的强弱，正确答案及其理由是：<br>能。最后的信号是接收到的射频信号经过放大处理得到的，当然信号强声音越大<br>能。调频信号越强，频偏也必然越大，解调后的声音也越大<br>不能。因为信号越强，自动增益控制作用也越强，增益的急剧减小使声音反而被压低<br>不能。因为鉴频输出大小只取决于射频信号的频偏，而且正常信号的幅度会被限幅电路切齐到同样大小	不能。因为鉴频输出大小只取决于射频信号的频偏，而且正常信号的幅度会被限幅电路切齐到同样大小
LK0784 业余无线电通信最常用的三种基本调制方法，其缩写AM、FM和PM，它们的中文名称分别是：<br>幅度调制（调幅）、频率调制（调频）、电码调制（摩尔斯）<br>频率调制（调频）、脉码调制（调脉码）、幅度调制（调幅）<br>幅度调制（调幅）、频率调制（调频）、相位调制（调相）<br>幅度调制（调幅）、频率调制（调频）、脉宽调制（调脉宽）	幅度调制（调幅）、频率调制（调频）、相位调制（调相）
LK0785 业余无线电通信方式缩写CW的英文原词意义是：<br>移频键控<br>莫尔斯编码<br>幅度键控<br>等幅电报	等幅电报
LK0786 对于给定的FM发射设备，决定其射频输出信号实际占用带宽的因素是：<br>所传输信号的幅度越大，射频输出占用带宽越宽，但与其频率无关<br>所传输信号的最高频率越高，射频输出占用带宽越宽，但与其幅度无关<br>射频输出实际占用带宽为由电路决定的固定值，通信常用的是25kHz或12.5kHz<br>所传输信号的最高频率越高、幅度越大，射频输出占用带宽越宽	所传输信号的最高频率越高、幅度越大，射频输出占用带宽越宽
LK0787 对于给定的SSB发射设备，决定其输出信号实际占用带宽的因素是：<br>所传输信号的幅度越大，射频输出占用带宽越宽，但与其频率和带宽无关<br>射频输出实际占用带宽为由电路决定的固定值，通信常用的是2.7kHz<br>所传输信号的带宽越宽，射频输出占用带宽越宽，但与其幅度和最高频率无关<br>所传输信号的最高频率越高，射频输出占用带宽越宽，但与其幅度和带宽无关	所传输信号的带宽越宽，射频输出占用带宽越宽，但与其幅度和最高频率无关
LK0788 用设置在NFM方式的对讲机接收WFM信号，其效果为：<br>可以正常听到信号，但声音比较小<br>可以正常听到信号，但声音的高音频部分衰减较大，缺乏高音<br>听不到信号，但接收到信号时调频噪声会变得寂静<br>可以听到信号，但当调制信号幅度较大、音调较高时会发生明显非线性失真	可以听到信号，但当调制信号幅度较大、音调较高时会发生明显非线性失真
LK0789 用设置在WFM方式的对讲机接收NFM信号，其效果为：<br>可以正常听到信号，但声音比较小<br>可以听到信号，但当调制信号幅度较大、音调较高时会发生明显非线性失真<br>可以正常听到信号，但声音的高音频部分衰减较大，缺乏高音<br>听不到信号，但接收到信号时调频噪声会变得寂静	可以正常听到信号，但声音比较小
LK0790 调频接收机没有接收到信号时，会输出强烈的噪声。关于这种噪声的描述是：<br>由天线接收到的背景噪声的随机幅度变化经放大形成，其大小与天线背景噪声电压的平方根成正比<br>由天线背景噪声和机内电路噪声的随机频率变化经鉴频形成，其大小与天线接收到的背景噪声幅度无关<br>由天线接收到的背景噪声的随机幅度变化经放大形成，其大小与天线背景噪声电压成正比<br>由天线接收到的背景噪声的随机幅度变化经放大形成，其大小与天线背景噪声电压的平方成正比	由天线背景噪声和机内电路噪声的随机频率变化经鉴频形成，其大小与天线接收到的背景噪声幅度无关
LK0791 什么叫做“鉴频”？<br>判断信号频率是否发生了不应有的偏离或者漂移过程称为鉴频<br>对调幅信号进行解调的过程称为鉴频<br>判断信号频率是否超过允许的频率范围的过程称为鉴频<br>对调频信号进行解调的过程称为鉴频	对调频信号进行解调的过程称为鉴频
LK0792 什么叫做“检波”？<br>对调幅信号进行解调的过程称为检波<br>检查信号频率是否发生了不应有的偏离或者漂移过程称为检波<br>检查信号波形是否超过允许的幅度范围的过程称为检波<br>对调频信号进行解调的过程称为检波	对调幅信号进行解调的过程称为检波
LK0793 利用个人电脑和用于传送语音的普通收发信机进行业余短波SSTV通信所用到的调制方式为：<br>FSK（图像信息的音频基带信号调制）和SSB（频率搬移）<br>FM（图像信息的音频基带信号调制）和SSB（频率搬移）<br>仅使用到SSB调制<br>PSK（图像信息的音频基带信号调制）和SSB（频率搬移）	FM（图像信息的音频基带信号调制）和SSB（频率搬移）
LK0794 利用个人电脑和用于传送语音的普通收发信机进行业余短波RTTY通信所用到的调制方式有：<br>PSK（数字信息的音频基带信号调制）和SSB（频率搬移）<br>FSK（数字信息的音频基带信号调制）和SSB（频率搬移）<br>仅使用到SSB调制<br>AM（数字信息的音频基带信号调制）和SSB（频率搬移）	FSK（数字信息的音频基带信号调制）和SSB（频率搬移）
LK0795 利用个人电脑和用于传送语音的普通收发信机进行业余短波PSK31通信所用到的调制方式有：<br>ASK（数字信息的音频基带信号调制）和SSB（频率搬移）<br>FSK（数字信息的音频基带信号调制）和SSB（频率搬移）<br>仅使用到SSB调制<br>PSK（数字信息的音频基带信号调制）和SSB（频率搬移）	PSK（数字信息的音频基带信号调制）和SSB（频率搬移）
LK0796 利用PC电脑和用于传送语音的普通收发信机进行业余短波PACKET通信所用到的调制方式有：<br>FSK（数字信息的音频基带信号调制）和SSB（频率搬移）<br>仅使用到SSB调制<br>AM（数字信息的音频基带信号调制）和SSB（频率搬移）<br>PSK（数字信息的音频基带信号调制）和SSB（频率搬移）	FSK（数字信息的音频基带信号调制）和SSB（频率搬移）
LK0797 SSTV或ATV接收到的图像有时发生左右倾斜为平行四边形或斜粗条纹的现象，是因为：<br>双方设备没有准确调谐在同一频率上<br>双方的行频、帧频一致，但是帧扫描的初始时刻不同步<br>双方的扫描行频不一致。<br>双方设备没有正确设置调制极性	双方的扫描行频不一致。
LK0798 SSTV 或ATV接收到的图像有时发生中间出现水平粗黑条纹、上下半帧图像错位的现象，是因为：<br>双方的扫描行频不一致。<br>双方的行频、帧频一致，但是帧扫描的初始时刻不同步<br>双方设备没有正确设置调制极性<br>双方设备没有准确调谐在同一频率上	双方的行频、帧频一致，但是帧扫描的初始时刻不同步
LK0799 业余无线电慢扫描电视传送的是：<br>逐行扫描的活动图像<br>逐行扫描的静止图像<br>交叉扫描的活动图像<br>交叉扫描的静止图像	逐行扫描的静止图像
LK0800 业余无线电模拟慢扫描电视图像的常用行分辨率为：<br>每帧128或256行<br>每帧640或720行<br>每帧320或640行<br>每帧768或1024行	每帧128或256行
LK0801 业余无线电模拟慢扫描电视图像的音频基带调制方式以及图像信息和调制信号的对应关系为：<br>调幅，白电平为低频率（1200Hz），黑电平为高频率（2000Hz），同步电平为最高频率（2300Hz）<br>调频，白电平为高频率（2300Hz），黑电平为低频率（1500Hz），同步电平为最低频率（1200Hz）<br>调幅，白电平为低电平（75%），黑电平为高电平（75%），同步电平为最高电平（100%）<br>调幅，白电平为高电平（87.5%），黑电平为低电平（30%），同步电平为最低电平（25%）	调频，白电平为高频率（2300Hz），黑电平为低频率（1500Hz），同步电平为最低频率（1200Hz）
LK0802 某业余电台要通过短波话音信道传输分辨率为1024x768像素甚至更为精细的电路图，适当的通信方式为： <br>模拟慢扫描电视（SSTV）<br>数字慢扫描电视（DSSTV）或无线电传真（FAX）<br>无线电传（RTTY）<br>业余电视（ATV）	数字慢扫描电视（DSSTV）或无线电传真（FAX）
LK0803 在监听Robot、Scotte、Martin、SC2等方式的业余SSTV通信时，可以听到信号中伴有一种非常规则的每秒钟重复数次的短促的“咯、咯”声，它们是：<br>一种超低频寄生振荡<br>标准频率信标<br>行同步信号<br>图像信号和载频之间的差拍	行同步信号
LK0804 业余SSTV通信和有些模拟ATV采用调频方式而不是广播电视图像的调幅方式，主要原因是： <br>便于与调频通话方式所使用的设备兼容<br>调频方式占用的频带比调幅方式窄<br>业余电台信号较弱，调频解调可以更好地抗拒叠加在信号上的外界噪声所引起的幅度变化<br>调频收信设备的灵敏度比调幅的高一个数量级	业余电台信号较弱，调频解调可以更好地抗拒叠加在信号上的外界噪声所引起的幅度变化
LK0805 在业余模拟SSTV通信中，Robot、Scottie、AVT、Martin等不同传送方式有什么差别？<br>操作难度不同<br>占用频带宽度不同<br>要求的接收机灵敏度不同<br>像素分辨率、像素调制方法、行频、帧频等参数不同，适用于不同画质和环境条件	像素分辨率、像素调制方法、行频、帧频等参数不同，适用于不同画质和环境条件
LK0806 在数字通信中，同时传送多位二进制信息的方式属于并行通信。下列业余无线电数字通信方式中，属于并行通信的有：<br>BPSK<br>PACKET<br>RTTY<br>MFSK16	MFSK16
LK0807 假设以同样的信息传输速率传输报文，MFSK16通信方式的波特率低于信息传输速率，RTTY通信方式的波特率等于信息传输速率。根据这一描述，两者相比可以做以下推论：<br>前者每个信号的宽度比较宽，因此抗御突发干扰的性能好，有利于短波DX通信<br>既然两者信息传输速率相同，通信效果是完全一样的<br>后者的实际通信能力可能更强些，任何情况下波特率总是越高越好<br>这一描述本身有问题，波特率应该总是等于信息传输速率的	前者每个信号的宽度比较宽，因此抗御突发干扰的性能好，有利于短波DX通信
LK0808 根据数据串行通信收发两端的时钟只需要在传送一个字节的时间内保持同步还是需要在传送一整块数据的时间内保持同步，可以分为“异步”和“同步”两种方式。下列业余无线电数字通信方式中属于异步方式的例子是：<br>PACTOR-II<br>RTTY<br>QPSK31<br>PACKET	RTTY
LK0809 根据数据串行通信收发两端的时钟只需要在传送一个字节的时间内保持同步还是需要在传送一整块数据的时间内保持同步，可以分为“异步”和“同步”两种方式。下列业余无线电数字通信方式中不属于同步方式的例子是：<br>PACKET<br>BPSK31<br>AMTOR-FEC<br>RTTY	RTTY
LK0810 在进行串行异步数字通信时，双方需要设置相同的波特率，数据位数，校验位数，停止位数。RTTY最常用的设置为：<br>50（或45.45），8，2，3<br>31.25，7，170，0.3<br>50（或45.45），5，N，1<br>2295，2125，170，5	50（或45.45），5，N，1
LK0811 我国GB2312-80《信息交换用汉字编码字符集-基本集》标准共收录6763个汉字。不考虑误码的情况，如果要以单个汉字为单位，传输由该字符集的汉字汉字组成的总长度为100字的报文，用RTTY和PSK31通信方式至少分别需要发送多少个字符？<br>100,100<br>300,200<br>200,200<br>400,200	300,200
LK0812 模拟ATV和模拟广播电视通信中，图像信号调制方式的差别是：<br>ATV为FM或AM，广播电视为AM<br>ATV 为PSK，广播电视为ASK<br>ATV为标清方式，广播电视为高清方式<br>ATV 为AM，广播电视为FM	ATV为FM或AM，广播电视为AM
LK0813 无线电发射机的效率是指：<br>输出到天线系统的信号功率与发射机所消耗的电源功率之比<br>输出到天线系统的有用信号功率与到达天线的包含杂散等无用信号的总功率之比<br>通信对象的接收天线得到的信号功率与发射机输出到天线系统的信号功率之比<br>通信对象的接收天线得到的信号功率与发射机所消耗的电源功率之比	输出到天线系统的信号功率与发射机所消耗的电源功率之比
LK0814 业余无线电发射机的效率总是明显低于1。所损耗的那部分能量：<br>损耗的能量消失在电容、电感、开关器件等零部件中<br>绝大部分转化为杂散等无用信号的电磁辐射<br>绝大部分因阻抗失配而返回电源，极小部分转化为无用信号的电磁辐射<br>绝大部分转化为热量，极小部分转化为无用信号的电磁辐射	绝大部分转化为热量，极小部分转化为无用信号的电磁辐射
LK0815 自制业余无线电发射设备，在经无线电检测机构检测合格并取得电台执照之前，调试时天线输出端应连接（或串联必要的仪表后连接）：<br>假负载<br>VSWR严格等于1:1的驻波天线<br>测试专用的标准环形天线<br>VSWR严格等于1:1的行波天线	假负载
LK0816 接收机灵敏度指标数值大小所反映的意义是：<br>灵敏度指标数值越大，对与有用信号同时出现的干扰信号的响应越灵敏<br>灵敏度指标数值越小，接收最小信号的能力越强<br>灵敏度指标数值越小，对与有用信号同时出现的干扰信号的响应越灵敏<br>灵敏度指标数值越大，接收最小信号的能力越强	灵敏度指标数值越小，接收最小信号的能力越强
LK0817 用功率电平表示的接收机灵敏度的意义以及常用单位是：<br>输出信号达到一定质量标准时输入信号与输出信号的功率电平比，单位dB<br>输出信号达到一定质量标准时输入信号的最小功率电平，单位dBm或dBμW<br>输出信号维持一定质量标准时输入信号的最小和最大功率电平之比，单位dB<br>输出信号达到一定质量标准时输出信号与输入信号的功率电平比，单位dB	输出信号达到一定质量标准时输入信号的最小功率电平，单位dBm或dBμW
LK0818 用电压电平表示的接收机灵敏度在无线电理论中的意义以及常用单位是：<br>输出信号达到一定质量标准时输入信号的最小电动势，单位μV，或换算成dBμV、dBmV<br>输出信号达到一定质量标准时输出信号与输入信号的电压比，单位dB/V或dB/mV<br>输出信号达到一定质量标准时输入信号的最大电动势，单位μV或mV<br>输出信号达到一定质量标准时输入信号的最小电压，单位μV，或换算成dBμV、dBmV	输出信号达到一定质量标准时输入信号的最小电动势，单位μV，或换算成dBμV、dBmV
LK0819 静噪灵敏度是指：<br>带有静噪功能的接收机关闭静噪功能时，按照灵敏度定义测得的灵敏度<br>带有静噪功能的接收机开启静噪功能时，按照灵敏度定义测得的灵敏度<br>能够使静噪电路退出静噪状态的射频信号最小输入电平<br>关闭静噪电路时所能接收到的最小射频信号的输入电平	能够使静噪电路退出静噪状态的射频信号最小输入电平
LK0820 甲乙两种业余无线电台设备资料列出接收机灵敏度指标分别为0.1μV和0.15μV。正确的推论为：<br>可以推断甲机接收微弱信号的能力比乙机的高，因为可以接收的信号更微弱<br>可以推断甲机接收微弱信号的能力比乙机的低，因为灵敏度数值比较小<br>凭此指标还无法比较两者接收微弱信号的能力，因没有给出测量灵敏度时的输出信号质量条件<br>可以推断甲机承受强信号的能力比乙机的低，因为灵敏度数值比较小	凭此指标还无法比较两者接收微弱信号的能力，因没有给出测量灵敏度时的输出信号质量条件
LK0821 输出信号达到一定质量标准时，在某输入阻抗为50欧的接收机天线输入端测得输入信号的最小电压为1μV，该接收机敏度用电压μV表示的数值为：<br>1μV<br>0.5μV<br>50μV<br>2μV	2μV
LK0822 输出信号达到一定质量标准时，在某输入阻抗为50欧的接收机天线输入端测得输入信号的最小电压为1μV，该接收机灵敏度的功率电平dBm数值为：<br>-107dBm<br>-103dBm<br>-73dBm<br>-113dBm	-107dBm
LK0823 输出信号达到一定质量标准时，在某输入阻抗为50欧的接收机天线输入端测得输入信号的最小电压为1μV，该接收机敏度用dBμV表示的数值为：<br>0dBμV<br>3dBμV<br>-2dBμV<br>6dBμV	6dBμV
LK0824 输出信号达到一定质量标准时，在某输入阻抗为50欧的接收机天线输入端测得输入信号的最小电压为0.5μV，该接收机敏度用电压μV表示的数值为：<br>0.5μV<br>2.5μV<br>50μV<br>1μV	1μV
LK0825 输出信号达到一定质量标准时，在某输入阻抗为50欧的接收机天线输入端测得输入信号的最小电压为0.5 μV，该接收机敏度的功率电平dBm数值为：<br>-107dBm<br>-103 dBm<br>-73 dBm<br>-113 dBm	-113 dBm
LK0826 输出信号达到一定质量标准时，在某输入阻抗为50欧的接收机天线输入端测得输入信号的最小电压为0.5μV，该接收机敏度用dBμV表示的数值为：<br>0dBμV<br>3dBμV<br>6dBμV<br>-2dBμV	0dBμV
LK0827 已知接收机天线输入阻抗为50Ω，电压灵敏度为2μV，其功率灵敏度为：<br>-107dBm<br>0.02dBm<br>-103dBm<br>-113dBm	-107dBm
LK0828 已知接收机天线输入阻抗为50Ω，电压灵敏度为1μV，其功率灵敏度为：<br>-103dBm<br>0.01dBm<br>-113dBm<br>-107dBm	-113dBm
LK0829 决定接收机抗拒工作频率附近QRM的主要选择性指标是：<br>前端带宽<br>带内波动和信道带宽<br>镜像抑制比<br>信道带宽、信道选择性和信道滤波器特性矩形系数	信道带宽、信道选择性和信道滤波器特性矩形系数
LK0830 决定接收机接收SSB信号时语音频响均匀度的主要选择性指标是：<br>镜像抑制比<br>前端带宽<br>带内波动和信道带宽<br>信道带宽、信道选择性和信道滤波器特性矩形系数	带内波动和信道带宽
LK0831 决定接收机抗拒与工作频率相距较远的强信号干扰的主要选择性指标是：<br>带内波动和信道带宽<br>镜像抑制比<br>信道带宽、信道选择性和信道滤波器特性矩形系数<br>前端带宽	前端带宽
LK0832 决定接收机抗拒与工作频率相距两倍于中频的频率上强信号干扰的主要选择性指标是：<br>带内波动和信道带宽<br>镜像抑制比<br>信道带宽、信道选择性和信道滤波器特性矩形系数<br>前端带宽	镜像抑制比
LK0833 “信噪比（SNR）”是无线电技术大量使用的名词，它是指：<br>有用信号功率对有用信号功率及噪声功率之和的比值<br>有用信号电压幅度对有用信号电压幅度及噪声电压幅度之和的比值<br>有用信号电压幅度对噪声电压幅度的比值<br>有用信号功率对噪声功率的比值	有用信号功率对噪声功率的比值
LK0834 对于需要接收微弱信号的业余通信，接收机的噪声系数Fn （以比值的数值形式表达）是一项重要技术指标。它是指：<br>接收机输入端信噪比Si/Ni对输出端信噪比So/No的比值<br>接收机输入端无信号时，输出端的噪声功率电平<br>接收机输入端噪声功率电平与输出端噪声功率电平的比值<br>接收机输出端噪声功率电平与输入端噪声功率电平的比值	接收机输入端信噪比Si/Ni对输出端信噪比So/No的比值
LK0835 对于需要接收微弱信号的业余通信，接收机的噪声系数Fn （以比值的数值形式表达）是一项重要技术指标。关于Fn的一些基本常识是：<br>Fn一定大于1；在同样的灵敏度下Fn越接近于1越好<br>Fn一定小于1；在同样的灵敏度下Fn越接近于0越好<br>Fn一定小于1；在同样的灵敏度下Fn越接近于1越好<br>Fn一定大于1；在同样的灵敏度下Fn越大越好	Fn一定大于1；在同样的灵敏度下Fn越接近于1越好
LK0836 对于需要接收微弱信号的业余通信，接收机的噪声指数NF（以对数形式表达）是一项重要技术指标。它是指：<br>接收机输出端噪声功率电平与输入端噪声功率电平的比值的对数表达形式<br>接收机输入端无信号时，输出端的噪声功率电平的对数表达形式<br>接收机输入端噪声功率电平与输出端噪声功率电平的比值的对数表达形式<br>接收机输入端信噪比Si/Ni对输出端信噪比So/No的比值的对数表达形式	接收机输入端信噪比Si/Ni对输出端信噪比So/No的比值的对数表达形式
LK0837 对于需要接收微弱信号的业余通信，接收机的噪声指数NF（以对数形式表达）是一项重要技术指标。关于NF的一些基本常识是：<br>NF一定小于0；在同样的灵敏度下NF越接近于0越好<br>NF一定处于0和1之间；在同样的灵敏度下NF越接近于1越好<br>NF一定大于0；在同样的灵敏度下NF越接近于0越好<br>NF一定大于1；在同样的灵敏度下NF越大越好	NF一定大于0；在同样的灵敏度下NF越接近于0越好
LK0838 制约现代无线电接收机灵敏度的主要因素是：<br>放大电路的稳定性<br>机内噪声<br>放大电路的增益<br>电源噪声	机内噪声
LK0839 业余通信接收机大多带有接收信号强度指示。VHF/UHF频段的最小刻度S1对应于输入信号功率电平-141dBm（50Ω输入电压0.02μV）标为S1，而HF频段的S1则对应于输入信号功率电平-121dBm（0.2μV）。这是因为：<br>HF业余电台功率一般比较大，VHF/UHF电台功率比较小，因此需要不同的刻度标准<br>由于电路技术的原因，HF频段接收机的灵敏度只能做到比VHF/UHF频段低大约20dB<br>V/UHF频段较寂静而HF频段外界背景噪声电平较高，前者可感知的最小信号电平比后者低约20dB<br>HF业余电台主要用于DX通信，VHF/UHF电台主要做本地通信，因此需要不同的刻度标准	V/UHF频段较寂静而HF频段外界背景噪声电平较高，前者可感知的最小信号电平比后者低约20dB
LK0840 学习现代无线电技术或从事业余无线电制作时，经常遇到一种与超外差式收信机具有不同原理的“DC式收信机”。其中缩写DC是指：<br>数模变换（Digital-Analog Conversion），指包含有数模变换器的收信机<br>介质电容（Dielectric Capacitor），指采用了特殊介质电容器的收信机<br>直接变换（Direct-Covertion），即接收到的射频信号在解调处理之前不经过频率变换<br>直流（Direct Current），指用直流电源供电的收信机	直接变换（Direct-Covertion），即接收到的射频信号在解调处理之前不经过频率变换
LK0841 在超外差式收信机电路中，信号通道的有用信号频率比本振频率低（或者高）一个中频频率。但比本振频率高（或者低）一个中频频率的信号也可能窜入信号通道，称为“镜像频率干扰”或“镜频干扰”。某VHF对讲机使用说明书的技术指标部分给出了第一中频（IF）为45.05MHz，但没有更多的资料。由此可推测当接收145.00MHz信号时下述频率之一的强信号可能造成镜频干扰：<br>235.10MHz或54.90MHz<br>45.05MHz或90.10MHz<br>90.10MHz或.180.20MHz<br>190.05MHz或99.95MHz	235.10MHz或54.90MHz
LK0842 在超外差式收信机电路中，信号通道的有用信号频率比本振频率低（或者高）一个中频频率。但比本振频率高（或者低）一个中频频率的信号也可能窜入信号通道，称为“镜像频率干扰”或“镜频干扰”。某对讲机使用说明书的技术指标部分给出了在NFM方式时第一中频（IF）为47.25MHz，但没有更多的资料。由此可推测当接收145.00MHz信号时下述频率之一的强信号可能造成镜频干扰：：<br>239.50MHz或50.50MHz<br>50.50MHz或101.00MHz<br>151.50MHz或.202.00MHz<br>192.25MHz或97.75MHz	239.50MHz或50.50MHz
LK0843 在超外差式收信机电路中，信号通道的有用信号频率比本振频率低（或者高）一个中频频率。但比本振频率高（或者低）一个中频频率的信号也可能窜入信号通道，称为“镜像频率干扰”或“镜频干扰”。某对讲机使用说明书的技术指标部分给出了接收NFM信号时第一中频（IF）为47.25MHz，但没有更多的资料。由此可推测当接收435.00MHz信号时下述频率之一的强信号可能造成镜频干扰：<br>340.50MHz或529.50MHz<br>141.70MHz或.236.25MHz<br>387.75MHz或482.25MHz<br>47.25MHz或94.50MHz	340.50MHz或529.50MHz
LK0844 在超外差式收信机电路中，信号通道的有用信号频率比本振频率低（或者高）一个中频频率。但比本振频率高（或者低）一个中频频率的信号也可能窜入信号通道，称为“镜像频率干扰”或“镜频干扰”。某UHF对讲机的使用说明书技术指标部分给出了第一中频（IF）为58.525MHz，但没有更多的资料。由此可推测当接收435.00MHz信号时下述频率之一的强信号可能造成镜频干扰：<br>234.10.05MHz或.468.20MHz<br>58.525MHz或117.05MHz<br>376.475MHz或493.525MHz<br>317.95MHz或552.05MHz	317.95MHz或552.05MHz
LK0845 现代超外差式业余收发信机面板上常设有选择中频滤波器带宽的控制部件。这些中频滤波器负责抑制的干扰种类为：<br>突发脉冲干扰<br>镜像频率干扰<br>中频频率干扰<br>邻近频率干扰	邻近频率干扰
LK0846 超外差式业余收发信机中负责抑制镜像频率干扰的部件是：<br>变频级之后的中频滤波器<br>变频级之前的预选滤波器<br>带有音调控制的音频滤波器<br>中频放大级中的限幅电路	变频级之前的预选滤波器
LK0847 在超外差式变频装置中，所谓“上变频”和“下变频”分别是指：<br>中频频率高于输入频率为上变频方式，中频频率低于输入频率为下变频方式<br>本振频率高于输入频率为上变频方式，本振频率低于输入频率为下变频方式<br>输入频率高于本振频率为上变频方式，输入频率低于本振频率为下变频方式<br>输入频率高于中频频率为上变频方式，输入频率低于中频频率为下变频方式	中频频率高于输入频率为上变频方式，中频频率低于输入频率为下变频方式
LK0848 很多具有静噪功能的FM通信接收机在对方松开话筒PTT键后，会听到一声很明显的“嘶啦”或“喀拉”噪声拖尾，其原因是：<br>此类电路根据鉴频输出中的强高音频噪声分量判断电台信号是否消失，从而关断音频输出。该项检测需占用一定时间，造成静噪的延迟，短时间漏出鉴频噪声<br>该噪声是发射设备有目的地发射，作为结束发射的一种标志<br>接收机自动增益电路的时间常数造成<br>该噪声由发射台话筒PTT接点跳动造成，发射到接收端	此类电路根据鉴频输出中的强高音频噪声分量判断电台信号是否消失，从而关断音频输出。该项检测需占用一定时间，造成静噪的延迟，短时间漏出鉴频噪声
LK0849 无线电通信和测试设备、电视设备和音频设备常用的传输接口标准阻抗分别为：<br>50欧、600欧和75欧<br>50欧、50欧和75欧<br>50欧、75欧和600欧<br>75欧、50欧和16欧	50欧、75欧和600欧
LK0850 无线电通信领域中，在描述信号源、放大器、接收机等系统部件的内部噪声大小时，经常用“噪声温度”来度量。以接收机为例，等效噪声温度Te的意义是：<br>接收机的内部噪声功率等于一个接在天线输入端的优质匹配电阻产生相同的热噪声功率时电阻所具有的绝对温度<br>接收机内部噪声在输出端的功率可以使一个接在输出端上的匹配电阻加热升高的相对温度<br>接收机信噪比符合技术指标时所要求的设备环境温度<br>接收机内部噪声在输出端的功率可以使一个接在输出端上的匹配电阻加热到的绝对温度	接收机的内部噪声功率等于一个接在天线输入端的优质匹配电阻产生相同的热噪声功率时电阻所具有的绝对温度
LK0851 不产生任何内部噪声的理想放大器或接收机的噪声系数Fn、噪声指数NF和噪声温度Te分别为：<br>0，0dB，-273°K<br>0，0dB，-275°K<br>0，1dB，17°K<br>1，0dB，0°K	1，0dB，0°K
LK0852 如果一个接收业余卫星用的天线放大器工作在标准温度（17℃）下，其输入端接一副良好匹配的天线。如果放大器所产生的内部噪声与输入的热噪声等效，该放大器的噪声系数Fn、噪声指数NF和噪声温度Te分别为：<br>2，0dB，17°K<br>2，3dB，290°K<br>1，1dB，0°K<br>1，0dB，-273°K	2，3dB，290°K
LK0853 在接收通信电台的信号时，通常用射频增益和音频增益旋钮就可以获得适当的灵敏度和音量。为什么很多业余无线电接收机还要另设一个衰减（ATT）开关？<br>避免本台发射机的强信号损坏接收电路<br>遇特强的带内干扰时，打开ATT开关可防止音量过大而损坏扬声器或耳机 <br>通常增益控制旋钮的控制范围不够宽，ATT开关用来加宽增益控制范围<br>特强带外干扰可使前级器件进入非线性区而产生互调干扰，需在接收机最前端加入衰减	特强带外干扰可使前级器件进入非线性区而产生互调干扰，需在接收机最前端加入衰减
LK0854 “衰减”和“衰落”是无线电通信技术中常用的名词。它们的含义分别是指：<br>衰减和衰落是一回事，指信号通过信道或电路后发生幅度随时间而起伏<br>衰减是指信号通过信道或电路后发生幅度随时间而起伏，衰落是指信号通过信道或电路后功率减少<br>衰减和衰落是一回事，指信号通过信道或电路后功率减少<br>衰减是指信号通过信道或电路后功率减少，衰落是指信号通过信道或电路后发生幅度随时间而起伏	衰减是指信号通过信道或电路后功率减少，衰落是指信号通过信道或电路后发生幅度随时间而起伏
LK0855 如果业余中继台发射机被断断续续的干扰信号所启动，夹杂着不清楚的语音，根据覆盖区内其他业余电台的监听，确定中继台上行频率并没有电台工作。则：<br>可能是中继台附近的两个其他发射机的强信号在中继台上行频率造成了互调干扰<br>可能是中继台发射机发生了寄生振荡<br>肯定是中继台接收机受到了人为恶意干扰<br>可能是中继台接收机发生了寄生振荡	可能是中继台附近的两个其他发射机的强信号在中继台上行频率造成了互调干扰
LK0856 业余调频中继台发射机只要被上行信号正常启动，就会一直继续发射载波，上行信号消失不能使其停止。可能的原因是：<br>中继台上下行隔离不良，中继台发射的载波窜入中继台接收机造成自锁<br>中继台发射机电源电压不稳<br>中继台接收机电源电压不稳<br>肯定受到人为恶意干扰	中继台上下行隔离不良，中继台发射的载波窜入中继台接收机造成自锁
LK0857 业余调频中继台发射机被上行信号正常启动，但上行信号消失后经常会继续发射一段或长或短的时间并夹杂有一些不清楚的语音。可能的原因是：<br>肯定受到人为恶意干扰<br>中继台下行信号与附近的其他通信发射机形成对中继台上行频率的互调干扰<br>中继台发射机电源电压不稳<br>中继台接收机电源电压不稳	中继台下行信号与附近的其他通信发射机形成对中继台上行频率的互调干扰
LK0858 业余中继台上下行共用一副天线时，需要在接收机、发信机和天线之间插入一个：<br>收发信转换开关<br>功率分配器（power divider）<br>双工器（duplexer）<br>环形器（circulator）	双工器（duplexer）
LK0859 业余中继台上下行共用一副天线时，需要在接收机、发信机和天线之间插入一个双工器，其基本构造和作用为：<br>一个匹配网络，使天线、中继发射机、中继接收机三者之间都满足阻抗匹配条件<br>一组滤波器，阻止中继台发射信号反馈进入中继台接收机<br>一个环形器，使信号只能沿中继发射机-天线-中继接收机的方向前进<br>一组半导体开关，在中继台发射时关断中继台接收机	一组滤波器，阻止中继台发射信号反馈进入中继台接收机
LK0860 架设业余中继台前应确定台址附近没有能与中继台下行频率形成三阶互调的发射台。如果中继台的上、下行频率分别为fR和fT，可能造成这种三阶互调的干扰频率fX是：<br>2fT - fR 或 (fT + fR ) / 2<br>2（fT - fR） 或 2(fT + fR )<br>fT - fR 或 fT + fR<br>2fT 或 2fR	2fT - fR 或 (fT + fR ) / 2
LK0861 业余电台异频收发操作方式（split）的主要适用场合为：<br>一个业余电台使用独立的收信和发信设备时<br>两个业余电台不想使其他业余电台听到完整的对话内容时<br>通信双方之一使用频率固定的发信设备时<br>本台呼叫受到大量电台回答（pile-up）时将收发信号错开以避免干扰，或者通信双方处于不同的国际频率分配或频率规划区域时	本台呼叫受到大量电台回答（pile-up）时将收发信号错开以避免干扰，或者通信双方处于不同的国际频率分配或频率规划区域时
LK0862 业余无线电通信梅登海德网格定位系统（Maidenhead Grid Square Locator）是一种：<br>根据经纬度坐标对地球表面进行网格划分和命名，用以标示地理位置的系统<br>卫星定位系统<br>根据国际呼号系列对地球表面进行网格划分和命名，用以标示地理位置的系统<br>根据国际政治行政区划对地球表面进行网格划分和命名，用以标示地理位置的系统	根据经纬度坐标对地球表面进行网格划分和命名，用以标示地理位置的系统
LK0863 业余无线电通信常用的梅登海德网格定位系统网格名称的格式为：<br>4个字母或者6个字母<br>2个字母和2位数字、2个字母和2位数字再加2个字母<br>呼号前缀字母加2位数字和2个字母<br>4位数字或者6位数字	2个字母和2位数字、2个字母和2位数字再加2个字母
LK0864 业余无线电通信常用的梅登海德网格定位系统网格名称的长度是4字符或6字符，两者定位精度不同，差别为：<br>4字符网格根据国际呼号系列区分，6字符网格在4字符基础上加以经纬度细分<br>4字符网格名称用于HF频段通信，6字符网格名称用于VHF/UHF通信<br>两者网格大小不同，4字符网格为经度2度和纬度1度，6字符网格为经度5分和纬度2.5分<br>4字符网格精确到国家分区，6字符网格精确到国家的城市或县乡	两者网格大小不同，4字符网格为经度2度和纬度1度，6字符网格为经度5分和纬度2.5分
LK0865 在HF频段DX竞赛中回答正在呼叫CQ的参赛电台的方法是，先通过守听搞清其守听频率，然后在其发送“QRZ？”或者在其CQ呼叫停止后进行如下操作：<br>在其呼叫频率上发送对方完整呼号和本台的完整呼号<br>在其呼叫频率上发送本台的完整呼号<br>在其守听频率上发送对方完整呼号和本台的完整呼号<br>在其守听频率上发送本台的完整呼号	在其守听频率上发送本台的完整呼号
LK0866 将接收机的输出与实时频谱仪或运行频谱显示软件的电脑相连，观察HF频段的RTTY或PACKET模式的DX信号，通常看到两个幅度相同的谱峰。但有时两个谱峰的高度会变得不等并且不断变化。造成这种现象的原因是：<br>发射机的发射功率电平不稳定<br>电离层的选择性衰落<br>接收机的自动增益控制不稳定<br>仪器或电脑工作点飘移	电离层的选择性衰落
LK0867 PACKET是业余无线电爱好者利用X.25数据分组通信协议开发的业余无线电通信方式，用于HF频段、VHF频段和卫星通信时通常采用的信号速率分别为：<br>300波特、1200波特、9600波特<br>1200波特、9600波特、19200波特<br>600波特、1200波特、2400波特<br>300波特、2400波特、19200波特	300波特、1200波特、9600波特
LK0868 有些常用的业余无线电数字通信协议只支持5位或者7位数据字节的传送，因而不适合用来传送8位字节的2进制数据文件。常用方式中能够支持2进制数据文件传输的是：<br>PSK31<br>RTTY<br>PACTOR<br>AMTOR	PACTOR
LK0869 业余无线电数据传输控制差错的技术有“前向纠错”和“自动重传请求”两种。前向纠错（Forward Error Correction，FEC）是指：<br>发送端在发送数据报文前先按一定的算法进行编码处理，加入特定的冗余代码，在接收端按照相应算法进行解码，从而发现传输产生的错误并加以纠正<br>发送端将每组数据报文重复发送足够多的次数，接收端收到后加以互相比较，选取比较一致的报文，以消除传输中的随机错误<br>发送端在发送一定数据后，如收到接收端的重传请求、或者收不到接收端的收妥确认，即重传出错的数据报文，对出错报文进行纠正<br>接收端收到数据后，发回发送端，由发送端比较核对，如发现出错，将重传出错的数据报文，从而恢复出错的报文	发送端在发送数据报文前先按一定的算法进行编码处理，加入特定的冗余代码，在接收端按照相应算法进行解码，从而发现传输产生的错误并加以纠正
LK0870 业余无线电数据传输控制差错的技术有“前向纠错”和“自动重传请求”两种。自动重传请求（Automatic Repeat Request，ARQ）是指：<br>接收端收到数据后，发回发送端，由发送端比较核对，如发现出错，将重传出错的数据报文，从而恢复出错的报文<br>发送端在发送数据报文前先按一定的算法进行编码处理，加入特定的冗余代码，在接收端按照相应算法进行解码，从而发现传输产生的错误并加以纠正<br>发送端将每组数据报文重复发送足够多的次数，接收端收到后加以互相比较，选取比较一致的报文，以消除传输中的随机错误<br>发送端在发送一定数据后，如收到接收端的重传请求、或者收不到接收端的收妥确认，即重传出错的数据报文，对出错报文进行纠正	发送端在发送一定数据后，如收到接收端的重传请求、或者收不到接收端的收妥确认，即重传出错的数据报文，对出错报文进行纠正
LK0871 国际2号电报码（ITA2）的俗称、在业余无线电通信中应用场合及其与计算机常用的数据交换代码相比的主要特点是：<br>ASCII码，用于PSK31通信，每字节仅包含7位二进制数据<br>莫尔斯电码，用于CW通信，每个字符包含的信号数量不等（非对称码）<br>GB2312编码，用于传输汉字，由两个字节连用代表一个汉字<br>博多码（Baudot code），用于RTTY通信，每字节仅包含5位二进制数据	博多码（Baudot code），用于RTTY通信，每字节仅包含5位二进制数据
LK0872 自由空间中甲乙两台相距100公里，均采用增益为0dBi的天线，发射端功率1W，工作频率为145MHz，接收端天线得到的信号功率约为-115.6dBm。如将距离增加为500km，接收到的信号功率将为：【提示：无线电波的自由空间路径损耗为：L=32.4+20logR+20logF，其中R为发射端到接收端的距离（km），F为工作频率（MHz）】<br>-129.6 dBm<br>-135.6 dBm<br>-101.6 dBm<br>-95.6 dBm	-129.6 dBm
LK0873 自由空间中甲乙两台相距100公里，均采用增益为0dBi的天线，发射端功率1W，工作频率为145MHz，接收端天线得到的信号功率约为-115.6dBm。如将距离增加为1000km，接收到的信号功率将为：【提示：无线电波的自由空间路径损耗为：L=32.4+20logR+20logF，其中R为发射端到接收端的距离（km），F为工作频率（MHz）】<br>-135.6 dBm<br>-101.6 dBm<br>-95.6 dBm<br>-129.6 dBm	-135.6 dBm
LK0874 自由空间中甲乙两台相距100公里，均采用增益为0dBi的天线，发射端功率1W，工作频率为145MHz，接收端天线得到的信号功率约为-115.6dBm。如将频率改为435MHz，接收到的信号功率将约为：【提示：无线电波的自由空间路径损耗为：L=32.4+20logR+20logF，其中R为发射端到接收端的距离（km），F为工作频率（MHz）】<br>-125.1 dBm<br>-135.6 dBm<br>-109.6 dBm<br>-129.6 dBm	-125.1 dBm
LK0875 自由空间中甲乙两台相距100公里，均采用增益为0dBi的天线，发射端功率1W，工作频率为145MHz，接收端天线得到的信号功率约为-115.6dBm。如将发射功率减少为0.25W，接收到的信号功率将为：【提示：无线电波的自由空间路径损耗为：L=32.4+20logR+20logF，其中R为发射端到接收端的距离（km），F为工作频率（MHz）】<br>-135.6 dBm<br>-129.6 dBm<br>-121.6 dBm<br>-109.6 dBm	-121.6 dBm
LK0876 自由空间中相距100km的甲乙两台通信，工作频率145MHz，接收端的信号强度指示为S8。如将距离增加为500km，接收信号强度指示将变为：【提示：无线电波的自由空间路径损耗为：L=32.4+20logR+20logF，其中R为发射端到接收端的距离（km），F为工作频率（MHz）；收信机信号强度指示S1至S9每挡相差6dB】<br>略高于S4<br>略高于S6<br>略低于S6<br>略低于S5	略低于S6
LK0877 自由空间中相距100km的甲乙两台通信，工作频率145MHz，接收端的信号强度指示为S8。如将距离增加为1000km，接收信号强度指示将变为：【提示：无线电波的自由空间路径损耗为：L=32.4+20logR+20logF，其中R为发射端到接收端的距离（km），F为工作频率（MHz）；收信机信号强度指示S1至S9每挡相差6dB】<br>略低于S5<br>略高于S5<br>S7<br>略高于S6	略低于S5
LK0878 自由空间中相距100km的甲乙两台通信，工作频率145MHz，接收端的信号强度指示为S8。如将频率改为435MHz，接收信号强度指示将变为：【提示：无线电波的自由空间路径损耗为：L=32.4+20logR+20logF，其中R为发射端到接收端的距离（km），F为工作频率（MHz）；收信机信号强度指示S1至S9每挡相差6dB】<br>S7<br>略低于S5<br>略高于S6<br>略低于S6	略高于S6
LK0879 自由空间中相距100km的甲乙两台通信，工作频率为145MHz，接收端的信号强度指示为S8。如将发射功率减少为原来的1/4，接收信号强度指示将变为：【提示：无线电波的自由空间路径损耗为：L=32.4+20logR+20logF，其中R为发射端到接收端的距离（km），F为工作频率（MHz）；收信机信号强度指示S1至S9每档相差6dB】<br>略低于S5<br>略高于S5<br>略高于S6<br>S7	S7
LK0880 某业余电台以100瓦功率发射时，对方接收机的信号强度指示为S8。现双方天线不变，将发射功率降到25瓦，对方接收的信号强度指示将变为：【提示：收信机信号强度指示S1至S9每档相差6dB】<br>S5<br>S6<br>S7<br>S4	S7
LK0881 某业余电台以80瓦功率发射时，对方接收机的信号强度指示为S8。现双方天线不变，将发射功率降为5瓦QRP，对方接收的信号强度指示将变为：【提示：收信机信号强度指示S1至S9每档相差6dB】<br>S2<br>S4<br>S6<br>S7	S6
LK0882 业余地球卫星的轨道倾角（inclination）是指包含：<br>轨道平面与地球赤道平面的夹角，由地球赤道平面在轨道升交点按顺时针方向计决定<br>轨道平面与地球赤道平面的夹角，由地球赤道平面在轨道降交点按顺时针方向计决定<br>轨道平面与地球赤道平面的夹角，由地球赤道平面在轨道降交点按逆时针方向计决定<br>轨道平面与地球赤道平面的夹角，由地球赤道平面在轨道升交点按逆时针方向计决定	轨道平面与地球赤道平面的夹角，由地球赤道平面在轨道升交点按逆时针方向计决定
LK0883 业余卫星的周期（period）是指：<br>连续两次经过地球北极的间隔时间<br>连续两次经过地球上某观测点的间隔时间<br>连续两次经过其轨道上的某特定点的间隔时间<br>连续两次经过地球赤道的间隔时间	连续两次经过其轨道上的某特定点的间隔时间
LK0884 地球同步（geosynchronous）卫星是指：<br>其轨道平面通过地球北极和南极地区的卫星<br>所经过地点的地方时基本相同的卫星<br>瞬时轨道平面与太阳始终保持固定取向的卫星<br>运行周期等于地球自转周期的地球卫星	运行周期等于地球自转周期的地球卫星
LK0885 太阳同步（轨道）（Sun-synchronousorbit）卫星是指：<br>瞬时轨道平面与太阳始终保持固定取向的卫星<br>运行周期等于地球自转周期的地球卫星<br>圆形及顺行轨道位于地球赤道平面上，并对地球保持相对静止的卫星<br>对地球保持大致相对静止的卫星	瞬时轨道平面与太阳始终保持固定取向的卫星
LK0886 地球(geostationary)静止卫星是指：<br>其轨道平面通过地球北极和南极地区的卫星<br>对地球保持大致相对静止的卫星<br>所有的地球同步卫星<br>所经过地点的地方时基本相同的卫星	对地球保持大致相对静止的卫星
LK0887 卫星升轨道（ascending pass）的方向是指轨道的下列区段：<br>由北向南<br>由南向北<br>由东南向西北<br>由东北向西南	由南向北
LK0888 卫星降轨道（descending pass）的方向是指轨道的下列区段：<br>由北向南<br>由东北向西南<br>由南向北<br>由东南向西北	由北向南
LK0889 卫星的周期是指：<br>卫星沿轨道绕地球一周所需的时间<br>卫星两次正好从地面某一点的正上方通过的间隔时间<br>卫星绕质心自旋一周所需的时间<br>卫星随地球绕太阳一周所需的时间	卫星沿轨道绕地球一周所需的时间
LK0890 卫星的线性转发器是指：<br>接收到的上行信号解调处理后经线性放大，再重新调制并转发的卫星中继设备<br>卫星上将接收到的一定带宽内的所有上行信号在频谱上平移（或平移加反转）后加以转发的中继设备<br>接收到的上行信号解调处理和重新调制后，经线性放大再转发的卫星中继设备<br>接收到的上行信号经线性放大后解调处理，再重新调制并转发的卫星中继设备	卫星上将接收到的一定带宽内的所有上行信号在频谱上平移（或平移加反转）后加以转发的中继设备
LK0891 卫星线性转发器的特点是：<br>转发工作频带范围内的所有信号而不改变原有的调制特征，可为各种常用业余无线电通信方式进行中继<br>转发器采用线性放大电路，转发的信号失真小<br>转发信号的幅度与上行信号幅度成线性正比，只能为CW、SSB和AM等带有振幅调制特征的通信方式进行中继<br>先对接收信号解调，经整形、线性放大后重新调制转发，提高下行信号高信噪比	转发工作频带范围内的所有信号而不改变原有的调制特征，可为各种常用业余无线电通信方式进行中继
LK0892 有时接收到的卫星下行信号强度会出现周期性的快衰落，这是因为：<br>卫星电源不够稳定<br>电波受高空气流的影响<br>卫星翻滚造成收发信天线极化的失配<br>电波受电离层的影响	卫星翻滚造成收发信天线极化的失配
LK0893 在安装卫星轨道预测软件后，在预测卫星位置之前必须进行的准备工作是：<br>输入当地的磁偏角和磁倾角<br>下载最近的太阳黑子平均数<br>下载待预测卫星的开普勒轨道根数（轨道要素）<br>下载最近的F107射电辐射通量	下载待预测卫星的开普勒轨道根数（轨道要素）
LK0894 业余低轨卫星的转发器覆盖范围有限。利用这类卫星进行全球性业余无线电通信的解决方法是：<br>地面业余电台换用更大功率的发射机<br>由地面站进行地面中继<br>由卫星对上行数据进行存贮和转发<br>增加地面业余电台的天线高度	由卫星对上行数据进行存贮和转发
LK0895 在业余无线电领域中，缩写AMSAT是指：<br>某一系列业余无线电卫星的总称<br>所有业余无线电卫星的总称<br>某一颗业余无线电卫星的名称<br>美国的业余无线电卫星公司，一个专注于实验卫星的设计、制造、运行和推进空间教育的非营利性志愿者组织	美国的业余无线电卫星公司，一个专注于实验卫星的设计、制造、运行和推进空间教育的非营利性志愿者组织
LK0896 在描述业余无线电卫星时经常用到缩写OSCAR（奥斯卡），这个名称的由来是：<br>电影奥斯卡金奖的基金所赞助的业余卫星活动<br>按照发明者奥斯卡的方案设计制造的业余卫星<br>“搭载有业余无线电装置的地球轨道卫星”的英文缩写<br>纪念业余无线电技术先驱者奥斯卡	“搭载有业余无线电装置的地球轨道卫星”的英文缩写
LK0897 我国发射的第一颗业余卫星的发射年份、名称、国际OSCAR系列号和转发器模式分别为：<br>2009年，希望一号（XW-1），HO68，V/U（J）<br>2008年，希望一号（XW-1），HO68，V/U（J）<br>2008年，希望一号（XW-1），无OSCAR编号，B<br>2010年，希望一号（XW-1），HO68，V/U（J）	2009年，希望一号（XW-1），HO68，V/U（J）
LK0898 业余电台在进行业余卫星通信时使用超过常规要求的发射功率，造成的结果以及对这种做法的态度是：<br>过强的上行信号会使卫星转发器压低对其他信道的转发功率，严重影响别人通信；必须反对<br>上行功率太大造成浪费和电磁污染；不提倡<br>上行功率越大，转发的效果越好，通信范围越大；可提倡<br>上行功率超过一定值对通信效果改善不大，但并无明显坏处；无所谓	过强的上行信号会使卫星转发器压低对其他信道的转发功率，严重影响别人通信；必须反对
LK0899 业余电台和业余卫星之间通信，VHF/UHF频段影响信号强度的主要因素是：<br>电离层对无线电波的吸收<br>大地对无线电波的吸收<br>电离层对无线电波的反射<br>无线电波在自由空间的衰减	无线电波在自由空间的衰减
LK0900 业余卫星通信中所说的A、B、K、JA、JD、S、T等工作方式，表示的是：<br>业余无线电转发器的发射功率等级<br>业余卫星的某些轨道参数<br>发射业余卫星的国家的呼号前缀<br>业余无线电转发器的上下行通信所用的业余频段以及所支持的调制方式	业余无线电转发器的上下行通信所用的业余频段以及所支持的调制方式
LK0901 业余卫星通信和业余无线电测向都会出现“多普勒效应”的概念。多普勒效应是指：<br>收发信机之间相对距离的变化使接收信号频率产生偏移的现象<br>传播条件随时间的扰动使接收信号幅度产生波动的现象<br>电波极化方向在传播途中变化使接收信号幅度产生波动的现象<br>传播条件随空间位置的扰动使接收信号幅度产生波动的现象	收发信机之间相对距离的变化使接收信号频率产生偏移的现象
LK0902 地面业余电台进行业余卫星通信时，接收到的卫星信号频率的多普勒频移规律是：<br>卫星飞来时频率偏低，飞离时频率偏高，越远频偏越大，过顶时频偏最小<br>卫星飞来时频率偏低，飞离时频率偏高，越远频偏越小，过顶时频偏最大<br>卫星飞来时频率偏高，飞离时频率偏低，越远频偏越小，过顶时频偏最大<br>卫星飞来时频率偏高，飞离时频率偏低，越远频偏越大，过顶时频偏最小	卫星飞来时频率偏高，飞离时频率偏低，越远频偏越大，过顶时频偏最小
LK0903 在特定方向上具有主辐射瓣的水平偶极天线，其振子的总长度应为：<br>1/2波长的任意整数倍<br>1/4波长的奇数倍<br>1/2波长的偶数倍<br>1/2波长的奇数倍	1/2波长的奇数倍
LK0904 在零仰角附近具有主辐射瓣的垂直接地天线，其振子的长度应为：<br>1/4波长的奇数倍<br>1/4波长的偶数倍<br>1/2波长的奇数倍<br>1/4波长的任意整数倍	1/4波长的奇数倍
LK0905 偶极天线与工作频率发生谐振的充分和必要条件是：<br>两臂总电气长度为工作波长的整数倍<br>两臂总电气长度为1/2工作波长的整数倍<br>两臂总电气长度为1/4工作波长的整数倍<br>两臂总电气长度为1/2工作波长的奇数倍	两臂总电气长度为1/2工作波长的整数倍
LK0906 偶极天线两臂总长度选取下列电气长度时，在垂直于天线轴线方向的增益达到峰值：<br>1/2工作波长的偶数倍<br>1/2工作波长的奇数倍<br>1/4工作波长的奇数倍<br>1/2工作波长的整数倍	1/2工作波长的奇数倍
LK0907 一副两臂电气长度各为1/4波长的偶极天线，断开中点，通过平衡-不平衡变换器进行馈电，测得谐振频率为f，输入阻抗为Z。如果总长度不变，但将断开的馈电点向一侧偏移1/8波长，最明显的影响将是：<br>谐振频率显著变高，相比之下阻抗变化不大<br>阻抗显著变大，相比之下谐振频率变化不大<br>阻抗显著变小，相比之下谐振频率变化不大<br>谐振频率显著变低，相比之下阻抗变化不大	阻抗显著变大，相比之下谐振频率变化不大
LK0908 天线和馈线之间经常接一个俗称“巴伦（BALUN）”的部件。“巴伦”的由来是：<br>平衡和不平衡两个英文字头的组合<br>宽带阻抗变压器的英文缩写<br>发明平衡不平衡转换器的人的名字<br>著名天线阻抗匹配理论家的名字	平衡和不平衡两个英文字头的组合
LK0909 天线和馈线之间经常接一个俗称“巴伦（BALUN）”的部件。它的主要功能是：<br>展宽天线的工作频带<br>在平衡电路和不平衡电路之间传递射频能量，并阻断两者之间的任何寄生耦合<br>实现天线和馈线之间的自动阻抗匹配<br>降低天线的驻波比	在平衡电路和不平衡电路之间传递射频能量，并阻断两者之间的任何寄生耦合
LK0910 在为业余电台选购射频电缆作为天线馈线时，最重要的两项电气参数是：<br>长度为1/4波长、终端分别为开路和短路时的电压驻波比<br>特性阻抗和工作频率下单位长度的传输功率损耗<br>铜或铝导线的截面积和常温下的最大额定电流<br>导线绝缘层的耐压和最高额定环境温度	特性阻抗和工作频率下单位长度的传输功率损耗
LK0911 同轴电缆的绝缘介质相同时，影响特性阻抗的因素是：<br>外导体内径越大，特性阻抗越高<br>外导体内径和内导体外径的比越大，特性阻抗越高<br>电缆的长度越长，特性阻抗越高<br>内导体外径越大，特性阻抗越高	外导体内径和内导体外径的比越大，特性阻抗越高
LK0912 一根特性阻抗为50欧的同轴电缆，一端接一个50欧电阻负载，用天线阻抗分析仪测量另一端在某工作频率下的实际阻抗。<br>读数取决于电缆长度，长1/4波长的奇数倍时接近无穷大，1/4波长偶数倍时接近零<br>读数取决于负载电阻的额定功率，额定功率越小，读数越大<br>读数为50欧，与电缆长度无关<br>读数取决于电缆长度，长1/4波长的偶数倍时接近无穷大，1/4波长奇数倍时接近零	读数为50欧，与电缆长度无关
LK0913 一根特性阻抗为50欧的同轴电缆，一端开路，用天线阻抗分析仪测量另一端在某工作频率下的实际阻抗。<br>读数为50欧，与电缆长度无关<br>读数取决于负载电阻的额定功率，额定功率越小，读数越大<br>读数取决于电缆长度，长1/4波长的奇数倍时接近无穷大，1/4波长偶数倍时接近零<br>读数取决于电缆长度，长1/4波长的偶数倍时接近无穷大，1/4波长奇数倍时接近零	读数取决于电缆长度，长1/4波长的偶数倍时接近无穷大，1/4波长奇数倍时接近零
LK0914 一根特性阻抗为50欧的同轴电缆，一端芯线和外屏蔽层短路，用天线阻抗分析仪测量另一端在某工作频率下的实际阻抗。<br>读数为50欧，与电缆长度无关<br>读数取决于电缆长度，长1/4波长的偶数倍时接近无穷大，1/4波长奇数倍时接近零<br>读数取决于负载电阻的额定功率，额定功率越小，读数越大<br>读数取决于电缆长度，长1/4波长的奇数倍时接近无穷大，1/4波长偶数倍时接近零	读数取决于电缆长度，长1/4波长的奇数倍时接近无穷大，1/4波长偶数倍时接近零
LK0915 用天线阻抗分析仪测量一副失配天线在某工作频率下的实际阻抗，发现配用不同的电缆连接仪器和天线时，得到的读数相差很大。为保证读数准确，可采取以下措施：<br>用高档纯银音响线材代替普通铜质同轴电缆<br>换用接触件镀金的高档电缆接头<br>使用电气长度正好等于波长的连接电缆<br>将电缆外皮妥善接地，并将仪器放入屏蔽室	使用电气长度正好等于波长的连接电缆
LK0916 制作工作频率为f（单位：兆赫兹）的某相控天线阵列需要长度为1/4波长的同轴电缆。其大致长度（单位：米）为： <br>71.3 / f<br>48.8 / f<br>75 / f<br>149.8 / f	48.8 / f
LK0917 制作工作频率为f（单位：兆赫兹）的半波长偶极天线。每个振子的大致长度（单位：米）为：<br>48.8 / f<br>142.6 / f<br>150 / f<br>71.3 / f	71.3 / f
LK0918 通常把垂直偶极天线或者垂直接地天线称为“全向天线”，是因为：<br>它们在水平方向没有指向性，但在立体空间有方向性<br>它们在垂直方向没有指向性，但在立体空间有方向性<br>它们在空间没有指向性，向各个方向均匀辐射<br>它们在水平方向和垂直方向都有指向性	它们在水平方向没有指向性，但在立体空间有方向性
LK0919 振子电气长度为1/4波长的垂直接地天线的最大辐射方向为：<br>在水平方向呈现8字形方向特性<br>在空间没有指向性，向各个方向均匀辐射<br>在水平方向没有指向性，在垂直方向指向水平面<br>在垂直方向没有指向性，在水平方向指向前方	在水平方向没有指向性，在垂直方向指向水平面
LK0920 短波水平偶极类天线（如偶极天线和八木天线等）的发射仰角主要由下列因素决定：<br>由天线振子导体所指的方向决定<br>由八木天线主梁所指的方向决定<br>由天线的辐射和大地的反射叠加造成，仰角高低与天线离地高度与波长的比值有关<br>由天线振子的长度所决定	由天线的辐射和大地的反射叠加造成，仰角高低与天线离地高度与波长的比值有关
LK0921 架设短波天线时，天线发射仰角的大致选择原则是：<br>近距离通信选择低发射仰角，远距离通信选择高发射仰角<br>较低频率通信选择低发射仰角，较高频率通信选择高发射仰角<br>远距离通信选择低发射仰角，近距离通信选择高发射仰角<br>近处开阔时选择低发射仰角，近处有建筑物时选择高发射仰角	远距离通信选择低发射仰角，近距离通信选择高发射仰角
LK0922 架设短波天线时，天线高度的大致选择原则是：<br>近处有建筑物时选择较低的高度，近处开阔时选择较高的高度<br>远距离通信选择较低的高度，近距离通信选择较高的高度<br>较低频率通信选择较高的高度，较高频率通信选择较低的高度<br>远距离通信选择较高的高度，近距离通信选择较低的高度	远距离通信选择较高的高度，近距离通信选择较低的高度
LK0923 在针对特定对象的DX通信中，计算天线最佳发射仰角的基本方法是：<br>根据通信双方的发射功率、天线极化方向、通信方向上障碍物所遮挡的仰角、太阳10.7 cm 射电流量，找公式计算<br>根据所使用电离层的大致高度、通信对象的大致距离、电波在传播途经中经电离层反射的次数，用简单几何方法计算<br>根据通信对象所在的方位、地球半径、对方天线高度、实际工作频率、太阳平均黑子数，查表计算<br>根据通信对象所在的方位、通信方向上障碍物所遮挡的仰角、本台周围的大地导电率、实际工作频率，找公式计算	根据所使用电离层的大致高度、通信对象的大致距离、电波在传播途经中经电离层反射的次数，用简单几何方法计算
LK0924 在HF远距离通信中，收发信天线周围的大地导电率对辐射效果的影响大致是：<br>大地导电率越低，大地中的感应电流越弱，效果越好<br>HF远距离通信依靠天波反射，与大地导电率无关<br>大地导电率越高，大地反射比较接近于理想情况，效果越好<br>大地导电率太高、太低都不好，最好是处于中间值	大地导电率越高，大地反射比较接近于理想情况，效果越好
LK0925 垂直接地天线（GP）的构造为电气长度为1/4波长的垂直振子加一个“接地”反射体，因其简单而被大量应用于手持和车载业余电台，但这种天线的实际工作情况往往与理论值相差较大，尤其在频率较低的频段。最常见的原因和改善办法是：<br>一般天线与电缆直接相连，匹配不良。在天线和电联之间加接“巴伦”即可解决问题<br>缺乏有效的接地反射体。GP天线必须有足够大的接地反射体来形成振子镜像，否则谐振频率和阻抗都将与理论值有显著偏差，应尽量用大面积金属体与天线的接地端直接连接<br>1/4波长垂直振子太短。在振子中串联加感线圈即可解决问题<br>1/4波长垂直振子太短。改成1/2波长即可解决问题	缺乏有效的接地反射体。GP天线必须有足够大的接地反射体来形成振子镜像，否则谐振频率和阻抗都将与理论值有显著偏差，应尽量用大面积金属体与天线的接地端直接连接
LK0926 天线增益是指：<br>天线在接收或发射信号时所具有的放大倍数<br>天线在最大辐射方向上的辐射功率密度与相同条件下基准天线的辐射功率密度之比<br>天线辐射到空间的电磁波功率与输入到天线的总射频功率之比<br>输入到天线的总射频功率与天线辐射到空间的电磁波功率之比	天线在最大辐射方向上的辐射功率密度与相同条件下基准天线的辐射功率密度之比
LK0927 业余条件测试天线增益的典型方法如图。用场强表或接收机接收设置在远处同一地点、最大辐射方向朝向自己的半波偶极天线（上）和待测天线（下）。调整送到两副天线的射频功率Po和P，使接收到的场强相同。待测天线的增益dBd值为：<br><img src="LK0927.jpg"><br>P - Po<br>10 lg(P/Po)<br>10 lg(P-Po)<br>10 lg(Po/P)	10 lg(Po/P)
LK0928 业余条件测试天线增益的典型方法如图。用场强表或接收机接收设置在远处同一地点、最大辐射方向朝向自己的半波偶极天线（上）和待测天线（下）。调整送到两副天线的射频功率Po和P，使接收到的场强相同。待测天线的增益dBi值为：<br><img src="LK0928.jpg"><br>10 lg(P/Po) + 2.15<br>10 lg(P-Po) + 2.15<br>10 lg(Po/P) + 2.15<br>20 lg(P/Po) + 2.15	10 lg(Po/P) + 2.15
LK0929 某商品天线说明书给出的增益指标以dBi为单位。其意义为：<br>“相对于半波长偶极子天线的增益”，即最大辐射方向上的辐射功率密度与半波长偶极振子的最大辐射功率密度之比<br>“相对于无方向性点源天线的增益”，即最大辐射方向上的辐射功率密度与理想点源天线的辐射功率密度之比<br>“相对于垂直短天线的增益”，即以高度远小于波长的短垂直天线作为基准作为比较基准得到的天线增益<br>“相对于1/4波长接地天线的增益”，即以1/4波长垂直接地天线作为比较基准得到的天线增益	“相对于无方向性点源天线的增益”，即最大辐射方向上的辐射功率密度与理想点源天线的辐射功率密度之比
LK0930 某商品天线说明书给出的增益指标以dBd为单位。其意义为：<br>“相对于无方向性点源天线的增益”，即最大辐射方向上的辐射功率密度与理想点源天线的辐射功率密度之比<br>“相对于1/4波长接地天线的增益”，即以1/4波长垂直接地天线作为比较基准得到的天线增益<br>这种表达没有说清楚计算增益所采用的比较基准，缺乏实际意义<br>“相对于半波长偶极子天线的增益”，即最大辐射方向上的辐射功率密度与半波长偶极振子的最大辐射功率密度之比	“相对于半波长偶极子天线的增益”，即最大辐射方向上的辐射功率密度与半波长偶极振子的最大辐射功率密度之比
LK0931 某商品天线说明书给出的增益指标以dB为单位。其意义为：<br>“相对于无方向性点源天线的增益”，即最大辐射方向上的辐射功率密度与理想点源天线的辐射功率密度之比<br>“相对于半波长偶极子天线的增益”，即最大辐射方向上的辐射功率密度与半波长偶极振子的最大辐射功率密度之比<br>这种表达没有说清楚计算增益所采用的比较基准，缺乏实际意义<br>“相对于垂直短天线天线的增益”，即以高度远小于波长的短垂直天线作为基准作为比较基准得到的天线增益	这种表达没有说清楚计算增益所采用的比较基准，缺乏实际意义
LK0932 两款VHF垂直全向天线，用作发射。甲天线增益4.5dBd，乙天线增益为5.85dBi。它们在远处某接收天线中形成的信号功率差为：<br>乙信号比甲信号强1.35dB<br>甲信号比乙信号强1.35dB<br>甲信号比乙信号强0.8dB<br>乙信号比甲信号强3.5dB	甲信号比乙信号强0.8dB
LK0933 两款VHF垂直全向天线，用作发射。甲天线增益2.9dBd，乙天线增益为5.85dBi。它们在远处某接收天线中形成的信号功率差为：<br>乙信号比甲信号强0.8dB<br>乙信号比甲信号强2.95dB<br>甲信号比乙信号强2.95dB<br>乙信号比甲信号强7.1dB	乙信号比甲信号强0.8dB
LK0934 通过目视判断全尺寸八木天线发射方向的办法是：<br>比主振子长者为引向振子，比主振子短者为反射振子，引向振子朝向最大辐射方向<br>比主振子短者为引向振子，比主振子长者为反射振子，引向振子朝向最大辐射方向<br>比主振子短者为引向振子，比主振子长者为反射振子，反射振子朝向最大辐射方向<br>主振子两端所指方向为最大辐射方向	比主振子短者为引向振子，比主振子长者为反射振子，引向振子朝向最大辐射方向
LK0935 在因空间限制、HF偶极天线达不到自然谐振所需长度而必须缩短时，可以在天线电路的某一点串入一个线圈，或者将整个振子做成一个线圈，加以补偿，构成“加感天线”。在充分优化设计的条件下，它们与全尺寸半波长偶极天线相比较的结果是：<br>如果设计得当、制作精心、妥善调试，有可能得到比全尺寸偶极天线更好的效果<br>只要设计得当、制作精心、妥善调试，可以得到和全尺寸天线完全一样的相同效果<br>无论是谐振和阻抗匹配条件还是辐射效率，都不能得到全尺寸天线的效果<br>可以和全尺寸天线一样满足谐振和阻抗匹配条件，但辐射效率肯定不如全尺寸天线	可以和全尺寸天线一样满足谐振和阻抗匹配条件，但辐射效率肯定不如全尺寸天线
LK0936 天线调谐器（俗称“天调”）的作用是：<br>补偿不匹配系统，向收发信机提供谐振的、阻抗匹配的负载，但不能改善天线本身的辐射效率<br>对不匹配的天馈系统进行补偿，虽然不能改善馈线的损耗，但能使天线本身的辐射效率达到匹配天线的水平<br>对不匹配的天馈系统进行补偿，使整个天馈系统的传输和辐射效率达到匹配天线的水平<br>对天馈系统进行优化调谐，使整个系统的辐射功率获得一个附加的增益	补偿不匹配系统，向收发信机提供谐振的、阻抗匹配的负载，但不能改善天线本身的辐射效率
LK0937 天线通过50欧同轴馈线与输出阻抗为50欧的收发信机相连接，并打算在天线电路中串入天线调谐器和通过式驻波功率计来监测和补偿天线的失配。理论上最理想的连接顺序为：<br>天线-天线调谐器-驻波功率计-馈线-收发信机<br>天线-驻波功率计-天线调谐器-馈线-收发信机<br>天线-馈线-天线调谐器-驻波功率计-收发信机<br>天线-天线调谐器-馈线-驻波功率计-收发信机	天线-天线调谐器-驻波功率计-馈线-收发信机
LK0938 塔上的天线通过50欧同轴馈线与输出阻抗为50欧的收发信机相连接，在天线电路中串入天线调谐器ATU和通过式驻波功率计M来监测和补偿天线的失配。有四种方案：1、ATU和M均在塔顶，2、ATU和M均在塔底，3、ATU在塔底、M在机房，4、ATU和M均在机房。当ATU调到最佳状态时，各方案按天线系统发射效率由高到低的排序为：<br><img src="LK0938.jpg"><br>方案3最好，方案4其次，方案2再其次，方案1最差<br>方案2最好，方案1其次，方案4再其次，方案3最差<br>方案1最好，方案2、3其次，方案4最差<br>方案4最好，方案2、3其次，方案1最差	方案1最好，方案2、3其次，方案4最差
LK0939 行波天线是一种依靠射频电流在长导线组成的连续匹配回路中流动产生辐射的天线，业余通信常用的有T2FD天线和贝伐列奇天线等。与驻波天线相比，行波天线的特点有：<br>对长度要求比较严格，是没有自然谐振点的宽带天线<br>在较宽的频带内具有一些列自然谐振频率点，但对长度要求比较严格<br>可以依靠天线调谐器实现在较宽的频带内谐振，对长度没有要求<br>是没有自然谐振点的宽带天线，对长度要求不严格但一般需接近或大于波长，	是没有自然谐振点的宽带天线，对长度要求不严格但一般需接近或大于波长，
LK0940 业余通信常用的T2FD行波天线和贝伐列奇等行波天线都在天线的终端接了一个无感电阻。关于它的作用，正确说法是：<br>长度足够时大部分功率边行进边辐射到空间，只剩小部分到达电阻并消耗而不反射回去<br>串联电阻的损耗降低了天线谐振时的Q值，使谐振响应显得平坦，但辐射效率比较低下<br>在匹配状态下，输入功率的一半消耗在电阻上，所以天线的辐射效率大约是50%<br>电阻相当于一个假负载，虽实现了宽带工作，但绝大部分能量消耗在这个电阻上	长度足够时大部分功率边行进边辐射到空间，只剩小部分到达电阻并消耗而不反射回去
LK0941 图示为我国业余电台野外通信常见的14MHz/21MHz/29MHz三频段偶极天线原理图。其中各段天线的电气长度应分别为：<br><img src="LK0941.jpg"><br>A为28MHz的半波长，B为21MHz的半波长，C为14MHz的半波长<br>A为28MHz的半波长，A+B为21MHz的半波长，A+B+C为14MHz的半波长<br>A为28MHz的1/4波长，A+B为21MHz的1/4波长，A+B+C为14MHz的1/4波长<br>A为28MHz的1/4波长，B为21MHz的1/4波长，C为14MHz的1/4波长	A为28MHz的1/4波长，A+B为21MHz的1/4波长，A+B+C为14MHz的1/4波长
LK0942 图示为我国业余电台野外通信常见的14MHz/21MHz/29MHz三频段偶极天线原理图。其中部件A、B、C、D的作用分别为：<br><img src="LK0942.jpg"><br>A、D为14MHz陷波器，B、C为21MHz陷波器，即分别谐振于14MHz和21MHz的串联谐振回路<br>A、D为14MHz陷波器，B、C为21MHz陷波器，即分别谐振于14MHz和21MHz的并联谐振回路<br>A、D为21MHz陷波器，B、C为28MHz陷波器，即分别谐振于21MHz和28MHz的串联谐振回路<br>A、D为21MHz陷波器，B、C为28MHz陷波器，即分别谐振于21MHz和28MHz的并联谐振回路	A、D为21MHz陷波器，B、C为28MHz陷波器，即分别谐振于21MHz和28MHz的并联谐振回路
LK0943 水平偶极天线振子的最短理想长度是工作频率的半波长。因条件限制而必须缩短振子时，不得不在天线的某个地方串入额外的电感将振子的自然谐振频率补偿到工作频率，但天线的效率比半波长天线有所降低。图为常用的方案，如果振子（红色部分）总长度相等，各方案的名称以及按发射效率由高到低的排序为： <br><img src="LK0943.jpg"><br>A-底部加感,B-中间加感, C-顶部加感<br>C-顶部加感,B-中间加感,A-底部加感<br>B-中间加感, A-底部加感, C-顶部加感<br>A-底部加感,C-顶部加感, B-中间加感	C-顶部加感,B-中间加感,A-底部加感
LK0944 垂直GP天线振子的最短理想长度是工作频率的1/4波长。因条件限制而必须缩短振子时，不得不在天线的某个地方串入额外的电感将振子的自然谐振频率补偿到工作频率，但天线的效率比1/4波长天线有所降低。图为常用的方案，如果振子（红色部分）总长度相等，各方案的名称以及按发射效率由高到低的排序为： <br><img src="LK0944.jpg"><br>B-中间加感, A-底部加感, C-顶部加感<br>A-底部加感, C-顶部加感, B-中间加感<br>C-顶部加感, B-中间加感, A-底部加感<br>A-底部加感, B-中间加感, C-顶部加感	C-顶部加感, B-中间加感, A-底部加感
LK0945 业余和专业无线电通信常用工作于不同频率的多副偶极天线的馈电点并联在一起构成多频段天线。对图示的由7MHz、14MHz和28MHz半波长振子组成的多频段天线的分析为：<br><img src="LK0945.jpg"><br>7MHz振子可以3/2波长方式工作于21MHz，可在7/14/21/28MHz四个频段工作；每个偶极天线的阻抗都是50欧，并联后总阻抗为17欧左右<br>只能工作于7/14/28MHz三个频段；每个偶极天线的阻抗都是50欧，并联后总阻抗为17欧左右<br>7MHz振子可以以3/2波长方式工作于21MHz，可在7/14/21/28MHz四个频段工作；不工作的振子呈现高阻抗，并联后总阻抗为50欧左右<br>只能工作于7/14/28MHz三个频段。不工作的振子呈现高阻抗；并联后的总阻抗为50欧左右	7MHz振子可以以3/2波长方式工作于21MHz，可在7/14/21/28MHz四个频段工作；不工作的振子呈现高阻抗，并联后总阻抗为50欧左右
LK0946 某业余电台使用半波长偶极天线发射时，对方接收机的信号强度指示为S4。现发射功率不变，发信端改用增益为 8.15 dBi的八木天线（最大辐射方向不变），对方接收的信号强度指示将变为：【提示：收信机信号强度指示S1至S9每档相差6dB】<br>S8<br>S6<br>S7<br>S5	S5
LK0947 某业余电台使用半波长偶极天线发射时，对方接收机的信号强度指示为S4。现发射功率不变，发信端改用增益为 12 dBd的八木天线（最大辐射方向不变），对方接收的信号强度指示将变为：【提示：收信机信号强度指示S1至S9每档相差6dB】<br>S7<br>S8<br>S6<br>S5	S6
LK0948 某业余电台使用半波长偶极天线发射时，对方亦使用半波长偶极天线接收，接收机的信号强度指示为S4。现发射功率不变，收发双方都改用增益为 8.15 dBi的八木天线（最大辐射方向不变），对方接收的信号强度指示将变为：【提示：收信机信号强度指示S1至S9每档相差6dB】<br>S5<br>S7<br>S6<br>S4	S6
LK0949 甲、乙业余电台相距2000公里，均使用1/2波长水平偶极天线，正在HF频段进行稳定的通信。现其中一方改用1/2波长垂直偶极天线，改变前后的通信效果的比较将是：<br>通信效果没有改变<br>通信效果的变化不确定，取决于当时天波反射途中极化方向的旋转情况<br>通信效果变差<br>通信效果变好	通信效果的变化不确定，取决于当时天波反射途中极化方向的旋转情况
LK0950 甲、乙业余电台相距10公里，均使用1/2波长水平偶极天线，正在UHF频段进行稳定的通信。现其中一方改用1/2波长垂直偶极天线，改变前后的通信效果的比较将是：<br>通信效果变差<br>通信效果变好<br>通信效果的变化不确定<br>通信效果没有改变	通信效果变差
LK0951 甲、乙业余电台相距10公里，分别使用1/2波长水平和垂直偶极天线，正在UHF频段进行稳定的通信。现改为双方都用1/2波长垂直偶极天线，改变前后的通信效果的比较将是：<br>通信效果的变化不确定<br>通信效果没有改变<br>通信效果变差<br>通信效果变好	通信效果变好
LK0952 甲、乙业余电台相距10公里，分别使用1/2波长水平和垂直偶极天线，正在UHF频段进行稳定的通信。现改为双方都用1/2波长水平偶极天线，改变前后的通信效果的比较将是：<br>通信效果变好<br>通信效果没有改变<br>通信效果变差<br>通信效果的变化不确定	通信效果变好
LK0953 甲、乙业余电台相距10公里，分别使用左旋圆极化和右旋圆极化天线，互相对指，正在UHF频段进行通信。现改为双方都用左旋圆极化天线，比较改变前后的通信效果是： <br>通信效果的变化不确定<br>通信效果没有改变<br>通信效果变差<br>通信效果变好	通信效果变好
LK0954 甲、乙业余电台相距10公里，分别使用左旋圆极化和右旋圆极化天线，互相对指，正在UHF频段进行通信。现改为双方都用右旋圆极化天线，改变前后的通信效果的比较将是： <br>通信效果变差<br>通信效果的变化不确定<br>通信效果变好<br>通信效果没有改变	通信效果变好
LK0955 甲、乙业余电台相距10公里，分别使用左旋圆极化和半波长水平极化天线，互相对指，正在UHF频段进行通信。现乙台改用半波长垂直极化天线，改变前后的通信效果的比较将是： <br>通信效果变好<br>通信效果变差<br>通信效果没有改变<br>通信效果的变化不确定	通信效果没有改变
LK0956 甲、乙业余电台相距10公里，分别使用左旋圆极化和半波长水平极化天线，正在UHF频段进行通信。现将甲台天线改为右旋圆极化天线，改变前后的通信效果的比较将是： <br>通信效果的变化不确定<br>通信效果变差<br>通信效果变好<br>通信效果没有改变	通信效果没有改变
LK0957 甲、乙业余电台相距10公里，甲台使用朝向乙台的左旋圆极化天线，乙台使用半波长水平极化天线，正在UHF频段进行通信。现将乙台天线改为朝向甲台的右旋圆极化天线，改变前后的通信效果的比较将是： <br>通信效果变差<br>通信效果变好<br>通信效果的变化不确定<br>通信效果没有改变	通信效果变差
LK0958 甲、乙业余电台相距10公里，甲台使用朝向乙台的左旋圆极化天线，乙台使用半波长水平极化天线，正在UHF频段进行通信。现将乙台天线改为朝向甲台的左旋圆极化天线，改变前后的通信效果的比较将是： <br>通信效果没有改变<br>通信效果变好<br>通信效果的变化不确定<br>通信效果变差	通信效果变好
LK0959 甲、乙业余电台相距10公里，分别使用左旋圆极化和右旋圆极化天线，互相对指，正在UHF频段进行通信。现将双方天线均改为半波长水平极化天线，改变前后的通信效果的比较将是： <br>通信效果的变化不确定<br>通信效果变好<br>通信效果变差<br>通信效果没有改变	通信效果变好
LK0960 影响短波电离层传播的主要因素有：<br>地表温度<br>当地天气<br>太阳黑子活动、太阳耀斑活动和地磁活动<br>发射机功率	太阳黑子活动、太阳耀斑活动和地磁活动
LK0961 影响短波电离层传播的主要因素有：<br>发射机功率<br>接收天线增益<br>季节和昼夜<br>当地地面气压	季节和昼夜
LK0962 影响短波电离层传播的主要因素有：<br>对流层气压<br>工作频率和通信距离<br>高空云量<br>发射机功率	工作频率和通信距离
LK0963 进行短波电离层传播预测所必需的参数为：<br>太阳黑子平均数、地磁活动指数、通信双方的位置、通信时间<br>太阳耀斑数量、地磁活动指数、通信双方的相对直线距离、通信时间<br>太阳黑子活动平均周期长度、通信双方的天线高度、通信双方位置的磁偏角、通信时间<br>上一太阳黑子活动周期的黑子平均数极大值、地磁活动指数、通信双方的相对直线距离、通信双方的高空温度	太阳黑子平均数、地磁活动指数、通信双方的位置、通信时间
LK0964 对短波电离层传播发生主要影响的各电离层按高度自低到高分别称为：<br>F、E2、E1、D<br>D、E、F1、F2<br>F2、F1、E2、E1<br>A、B、C、D	D、E、F1、F2
LK0965 对短波电离层传播发生主要影响的各电离层按离子密度自高到低分别为：<br>E1、E2、F1、F2<br>F、E2、E1、D<br>A、B、C、D<br>F2、F1、E、D	F2、F1、E、D
LK0966 各电离层对短波电离层传播所起的主要影响为：<br>F2、F1、E层可反射电波，D层不能反射但衰减电波<br>F1、E层可反射电波，D、F2层不能反射但衰减电波<br>F2、D层可反射电波，E、F1层不能反射但衰减电波<br>D、E层可反射电波，F1、F2层不能反射但衰减电波	F2、F1、E层可反射电波，D层不能反射但衰减电波
LK0967 太阳黑子活动的平均周期约为：<br>11.2年<br>5.7年<br>6.7年<br>38年	11.2年
LK0968 太阳黑子活动的强弱用“太阳黑子平均数（SSN）”来描述。一般说来：<br>SSN小,有利于短波远程通信<br>SSN与短波远程通信效果无直接关系<br>只有在发生太阳耀斑的情况下SSN 才会影响短波远程通信效果<br>SSN大,有利于短波远程通信	SSN大,有利于短波远程通信
LK0969 在业余无线电HF传播预测中，经常遇到缩写为F107的参数，其意义是：<br>FM广播频段107MHz的典型传播距离<br>电离层对10.7MHz电波的衰减指数<br>最高可用频率与10.7MHz的比值<br>太阳10.7cm波长射电辐射通量指数	太阳10.7cm波长射电辐射通量指数
LK0970 在业余无线电HF传播预测中，经常遇到缩写为F107的参数，其数值范围大致为60-300。数值越大，其意义为：<br>宁静太阳的辐射强度越强，电离层密度越大，不利于F层对DX电波的反射<br>宁静太阳的辐射强度越强，电离层密度越大，有利于F层对DX电波的反射<br>电离层对10.7MHz电波的衰减越大，说明DX传播的条件越差<br>FM广播频段107MHz的典型传播距离越远，可用作300公里以内的VHF传播距离预测	宁静太阳的辐射强度越强，电离层密度越大，有利于F层对DX电波的反射
LK0971 即使在空旷平地，接收到的本地VHF/UHF信号强度也可能会随着接收位置的移动而发生变化，最主要的可能原因是：<br>直射和经地面反射等多条路径到达的电波相位不同，互相叠加或抵消造成衰落（多径效应）<br>不同接收位置大地导电率有差异<br>移动过程中设备与大地之间的分布电容发生微小的变动<br>收发位置之间的空气流动造成电波折射不均匀而飘移	直射和经地面反射等多条路径到达的电波相位不同，互相叠加或抵消造成衰落（多径效应）
LK0972 无线电波在真空中的速度大致为：（”x＾m”表示“x的m次方”）<br>3×10＾7 米/秒<br>3×10＾8 米/秒<br>6.88×10＾6 米/秒<br>3.1416×10＾12 米/秒	3×10＾8 米/秒
LK0973 天线工程中计算振子长度时需要知道电波在天线中的传播速度。电波在天线导线中的传播速度大约是：<br>真空波速的1.41倍<br>真空波速的1.05倍<br>与真空波速相同<br>真空波速的0.95倍	真空波速的0.95倍
LK0974 天线工程中计算馈线长度时经常需要知道电波在馈线中的传播速度。常用业余频段的电波在同轴电缆中的传播速度大约是：<br>真空波速的1.65倍<br>与真空波速相同<br>真空波速的1.54倍<br>真空波速的0.65倍	真空波速的0.65倍
LK0975 什么是波阻抗？<br>电磁波传到远方时，电场E和磁场H在空间的比值为常量，称为波阻抗。<br>射频电流在同轴电缆中通过时遇到的阻抗就是波阻抗<br>射频电流在进入发射天线馈电点时遇到的阻抗就是波阻抗<br>射频电流在发射设备输出端遇到的外界阻抗就是波阻抗	电磁波传到远方时，电场E和磁场H在空间的比值为常量，称为波阻抗。
LK0976 什么叫“理想点源天线”？对业余无线电爱好者有什么意义？ <br>一种仅用于无线电测试的标准接收天线，但发射效果不好，对业余无线电无用处<br>一种小到一个点的、能把发射机的射频能量全部转换为电磁波并加以各向同性均匀辐射的理论假想天线。经常作为衡量实际天线辐射性能的比较基准<br>一种专业通信使用的增益极高的专用天线。在业余无线电中没有应用价值<br>一种带宽几乎无穷宽的高级天线专利的名称。业余无线电不需要这样的宽带天线	一种小到一个点的、能把发射机的射频能量全部转换为电磁波并加以各向同性均匀辐射的理论假想天线。经常作为衡量实际天线辐射性能的比较基准
LK0977 真空中理想点源天线发出的电磁波是一个均匀球面波，任何一个与传播途径垂直的空间截面上的功率通量密度的分布规律为：<br>功率通量密度与离辐射源的距离成指数关系<br>功率通量密度与离辐射源的距离成正比<br>功率通量密度与离辐射源的距离成反比<br>功率通量密度与离辐射源的距离的平方成反比	功率通量密度与离辐射源的距离的平方成反比
LK0978 自由空间中电磁波随距离而发散减弱的路径损耗为L＝20 lg d + 20 lg f + 32.44（其中损耗L的单位为dB，距离的单位为 km，频率f的单位为MHz）。由此可知，当频率一定时：（“X＾M”表示“X的二次方”）<br>距离增加到N倍，衰减增大到20×N倍<br>距离增加到N倍，衰减增大到N倍<br>距离增加到N倍，衰减增大到N＾2倍<br>距离增加到N倍，衰减增大到2×N倍	距离增加到N倍，衰减增大到N＾2倍
LK0979 自由空间中电磁波随距离而发散减弱的路径损耗为L＝20 lg d + 20 lg f + 32.44（其中损耗L的单位为dB，距离的单位为 km，频率f的单位为MHz）。由此可知，当距离一定时：（“X＾M”表示“X的二次方”）<br>频率增加到N倍，衰减增大到N＾2倍<br>频率增加到N倍，衰减增大到N倍<br>频率增加到N倍，衰减增大到2×N倍<br>频率增加到N倍，衰减减少到1/N，所以430MHz信号比144MHz强	频率增加到N倍，衰减增大到N＾2倍
LK0980 在电磁场理论中，关于“强度随离辐射源距离的平方成反比”的规律适用条件是：<br>仅适用于从LF到UHF的频率范围<br>仅适用于离辐射源大约10倍波长外的“远区场”<br>适用于辐射源周围空间内的任何一点<br>仅适用于离辐射源一定距离范围内的“远区场”	仅适用于离辐射源大约10倍波长外的“远区场”
LK0981 在空旷场地用场强计比较不同型号的辐射仰角为0的全向垂直天线在无线电通信中的实际辐射能力，需要注意：<br>待测天线的馈电电缆外面应套上磁环<br>测试点应选择在离天线至少10倍波长远的地方<br>场强计应与地面绝缘<br>场强计外壳应妥善接地	测试点应选择在离天线至少10倍波长远的地方
LK0982 80米波段业余无线电测向机多采用环形天线和鞭状天线分别接收信号的磁场和电场分量，组合得到心形图单向特性。但远处调好的方向性，往往在接近电台后变差而需要重新调整鞭状天线的长度。其原因是：<br>接近电台时信号场强导致接收机前级半导体器件过载<br>接近电台时信号场强导致鞭状天线进入非线性工作区<br>远场区内电场和磁场的比值不变，而近场区内恒比关系不再存在<br>接近电台时信号场强导致环形天线发热变形而改变参数	远场区内电场和磁场的比值不变，而近场区内恒比关系不再存在
LK0983 1.9MHz和3.5MHz等短波低频段业余DX通信经常使用到名词“灰线”。这是指：<br>地球上通信两端之间的大圆连线<br>连接地球具有相同最高可用频率的地点所形成的线<br>地球有极光活动的地区<br>地球自转时白昼和黑夜交界的区域	地球自转时白昼和黑夜交界的区域
LK0984 业余无线电爱好者经常用“灰线”预测1.9MHz和3.5MHz等短波低频段的DX通信效果，基本原理是：<br>通信两端分别处于灰线同一侧4000公里以外的两点时传播最好<br>通信两端分别处于灰线两侧4000公里以外的对称点时传播最好<br>通信两端应避免同时处于灰线才能取得更稳定的传播<br>通信两端同时处于灰线时最有利于建立天波的多跳反射途径	通信两端同时处于灰线时最有利于建立天波的多跳反射途径
LK0985 按照频率划分表，122.25—123GHz业余频段不能用于卫星业余业务，但这对业余卫星通信活动影响不大。这是因为：<br>业余无线电爱好者不具备制造工作在120GHz附近频段的设备的能力<br>120GHz附近频段存在特别强烈的宇宙射线干扰，不适合用作卫星通信<br>60GHz、120GHz、183GHz附近存在衰减很大的大气吸收频带，并不适合用作业余卫星通信<br>120GHz附近频段的天线尺寸太大，不适合用作业余卫星通信	60GHz、120GHz、183GHz附近存在衰减很大的大气吸收频带，并不适合用作业余卫星通信
LK0986 无线电波传播受降雨影响最严重的频段是：<br>低频LF（长波）<br>极高频EHF（毫米波）<br>特高频UHF（分米波）<br>高频HF（短波）	极高频EHF（毫米波）
LK0987 无线电波传播受降雨影响最严重的频段是：<br>中频MF（中波）<br>甚高频VHF（米波）<br>甚低频VLF（甚长波）<br>极高频EHF（毫米波）	极高频EHF（毫米波）
LK0988 垂直偶极天线所发射的无线电波的极化方式为：<br>右旋圆极化波<br>左旋圆极化波<br>水平极化波<br>垂直极化波	垂直极化波
LK0989 水平偶极天线所发射的无线电波的极化方式为：<br>水平极化波<br>左旋圆极化波<br>垂直极化波<br>右旋圆极化波	水平极化波
LK0990 假设收发天线均采用半波长偶极天线。在地面电台之间的近距离通信中，发射天线和接收天线的最佳极化方式为：<br>收发天线都处于垂直于两台连线的平面内并且极化方向互相一致<br>收发天线的极化方向都平行于两台之间的连线<br>收发天线都处于垂直于两台连线的平面内收发天线极化方向互相垂直<br>发信天线垂直极化，收信天线的极化方向平行于两台之间的连线	收发天线都处于垂直于两台连线的平面内并且极化方向互相一致
LK0991 假设收发天线均采用半波长偶极天线。在依靠电离层反射的远距离通信中，发射天线和接收天线的最佳极化方式为：<br>收发天线都处于垂直于两台连线的平面内收发天线极化方向互相垂直<br>收发天线都处于垂直于两台连线的平面内并且极化方向互相一致<br>收发天线的极化方向都平行于两台之间的连线<br>不确定，根据具体传播情况而经常变化	不确定，根据具体传播情况而经常变化
LK0992 右旋（或顺时针）极化波[right-hand（clockwise）polarized wave]是指：在任何一个垂直于传播方向的固定平面上，顺着传播方向看去，其电场向量随时间向右（顺时针方向）旋转的椭圆极化波或圆极化波。从地面某业余电台看一颗业余卫星，发现从卫星到达该台的无线电波的电场是按顺时针方向旋转的，其极化方式为：<br>左旋（或逆时针）椭圆极化波或圆极化波<br>垂直极化波<br>右旋（或顺时针）椭圆极化波或圆极化波<br>水平极化波	左旋（或逆时针）椭圆极化波或圆极化波
LK0993 在视距通信中，已知发射天线为指向接收点的左旋圆极化天线，接收天线的最佳极化方式为： <br>指向发射点的右旋圆极化<br>垂直极化<br>水平极化<br>指向发射点的左旋圆极化	指向发射点的左旋圆极化
LK0994 卫星采用右旋圆极化天线，从北向南飞行，天线一直指向地球的南极。地面业余电台采用自动跟踪的圆极化天线指向卫星。地面业余电台天线的最佳极化旋转方向为： <br>最佳方向始终为右旋圆极化<br>最佳方向始终为左旋圆极化<br>卫星过顶后为右旋圆极化，过顶前为左旋圆极化<br>卫星过顶前为右旋圆极化，过顶后为左旋圆极化	卫星过顶前为右旋圆极化，过顶后为左旋圆极化
LK0995 在视距通信中，已知发射天线是处于垂直于两台连线的平面内的偶极天线，但极化方向不断变化。能够保证在任何时刻信号都不会因极化问题而中断通信的接收天线极化方式为：<br>水平极化<br>垂直极化<br>指向发射点、右旋或左旋圆极化<br>极化方向平行于两台之间的连线	指向发射点、右旋或左旋圆极化
LK0996 防雷装置的作用是防止雷电危害。传统防雷装置的主要组成部分是：<br>接闪器（避雷针）、引下线、接地体<br>避雷针、高压指示灯、过流保护器<br>避雷针、过压保护器、熔丝<br>天线、限流器、地线	接闪器（避雷针）、引下线、接地体
LK0997 防雷接地的作用是：<br>有效地阻断接闪器引入的雷击电流使其不致流入大地<br>当接闪器引入雷击电流时迅速烧断熔丝，阻断其流动<br>用接闪器感应到的雷电高压启动过压保护电路<br>把接闪器引入的雷击电流有效地泄入大地	把接闪器引入的雷击电流有效地泄入大地
LK0998 关于对防雷接地基本要求的正确说法：<br>交流电网的“零线”在配电系统中已经接地，因此可代替防雷接地体及其引下线<br>接闪器到接地体之间的引下线平时没有电流流过，采用直径0.5毫米的导线为好<br>要有单独的接地体，接地电阻要小，接闪器到接地体之间的引下线应尽量短而粗<br>可以利用与埋地金属管线相连的自来水管作为接地体	要有单独的接地体，接地电阻要小，接闪器到接地体之间的引下线应尽量短而粗
LK0999 单支避雷针的保护范围大致有多大：<br>以避雷针为顶点、避雷针高度为半径的半球体以内空间<br>避雷针周围水平方圆30米内的任何物体<br>避雷针周围所有比避雷针低的空间<br>以避雷针为顶点的45度圆锥体以内空间	以避雷针为顶点的45度圆锥体以内空间
LK1000 安全电压是指不致使人直接致死或致残的电压。标准国家标准GB3805－83《安全电压》，一般环境条件下允许持续接触的“安全特低电压”为：<br>72V<br>48V<br>24V<br>6V	24V
LK1001 触及裸露的射频导线时，与触及相同电压的直流或50Hz交流导线相比，对人身安全危险的大致差别为：<br>射频电流对人体没有危险<br>致死危险性下降，但皮肤容易灼伤<br>更容易出现呼吸或心脏麻痹、更易致死<br>触及不同频率、相同电压的导线时，对人体的危害没有差别	致死危险性下降，但皮肤容易灼伤
LK1002 我国业余电台应该遵守的关于电磁辐射污染的具体管理规定文件为： <br>美国FCC《射频电磁场人员暴露准则的测评方法规》<br>国家标准GB/T 51391《通信工程建设环境保护技术标准》<br>国际非电离辐射防护委员会《限制时变电场和磁场暴露的导则》<br>《业余电台管理办法》	国家标准GB/T 51391《通信工程建设环境保护技术标准》
LK1003 按照我国国家标准GB/T 51391《通信工程建设环境保护技术标准》，向没有屏蔽空间发射电磁场可以免于管理的有： <br>发射频率30MHz以上的所有业余电台<br>发射频率30MHz以下的所有业余电台<br>所有业余电台<br>等效辐射功率在0.1-3MHz不大于300W、在3MHz-300GHz不大于100瓦的无线通信设施（设备） 	等效辐射功率在0.1-3MHz不大于300W、在3MHz-300GHz不大于100瓦的无线通信设施（设备） 
LK1004 按照我国国家标准《电磁辐射防护规定》，凡其功率大于豁免水平（3MHz以上等效辐射功率100瓦）的一切电磁波辐射体的所有者，必须：<br>向所在地区的环境保护部门申报、登记，并接受监督<br>向所在地区的无线电管理机构交纳环境电磁辐射监测报告<br>向所在地区的环境保护部门缴纳环境保护费<br>业余电台可不受环境保护部门的监督管理	向所在地区的环境保护部门申报、登记，并接受监督
LK1005 按照我国国家标准《电磁辐射防护规定》，负责对超过豁免水平（3MHz以上等效辐射功率100瓦）电磁波辐射体所在的场所以及周围环境的电磁辐射水平进行监测的是：<br>所在地区业余无线电协会<br>所在地区环境保护部门<br>其拥有者<br>所在地区无线电管理机构	其拥有者
LK1006 按照我国国家标准《电磁辐射防护规定》，当监测到超过豁免水平的电磁辐射体使环境电磁辐射水平超过规定的限值时，必须：<br>立即到环境保护部门缴纳电磁污染治理费<br>立即向当地城管机构报告<br>立即向无线电管理机构报告<br>尽快采取措施降低辐射水平，同时向环境保护部门报告	尽快采取措施降低辐射水平，同时向环境保护部门报告
LK1007 按照我国国家标准《电磁辐射防护规定》，对超过豁免水平的电磁辐射体的环境电磁辐射水平监测应在下列地点进行：<br>在发射机射频输出端口进行测量<br>在距辐射体天线2000米以内选择任意位置测量<br>在距辐射体天线100米以内最小辐射方向上选点测量<br>在距辐射体天线2000米以内最大辐射方向上选点测量	在距辐射体天线2000米以内最大辐射方向上选点测量
LK1008 我国国家标准《电磁辐射防护规定》所规定的电磁辐射防护限值的公众照射基本限值，其基本计量方法规是：<br>任何时刻的全身平均的比吸收率（SAR）都应小于每公斤体重限值<br>任何时刻的瞬时辐射场强都应小于与频率无关的固定限值<br>一天24小时内任意6分钟内全身平均的比吸收率（SAR）应小于每公斤体重限值<br>任何时刻的瞬时辐射场强都应小于与频率有关的限值	一天24小时内任意6分钟内全身平均的比吸收率（SAR）应小于每公斤体重限值
LK1009 我国国家标准《电磁环境控制限值》规定公众暴露控制限值中，对环境电磁辐射场强任意连续6分钟内的方均根值要求最严格的频率范围为： <br>1200MHz-30GHz<br>300kHz-30MHz<br>30MHz- 3GHz<br>3MHz- 30MHz	30MHz- 3GHz
LK1010 按照我国规定，购置使用公众对讲机不需取得批准。业余无线电爱好者需要与公众对讲机用户通信时应该：<br>将业余无线电台设置到公众对讲机的频率，但只能进行由业余无线电台到公众对讲机的单向发信<br>将业余无线电台设置到公众对讲机的频率，以不大于0.5W的发射功率与之通信<br>将业余无线电台设置到公众对讲机的频率，以不大于业余无线电台执照核定的发射功率与之通信<br>业余无线电台不能用于与公众对讲机通信	业余无线电台不能用于与公众对讲机通信
LK1011 填写和邮寄QSL卡片时的正确做法有：<br>自己的邮寄地址与电台的发射地点不同时，应在QTH栏目内填明详细邮寄地址<br>填写错误时应划去或使用涂改液覆盖错误内容并加以改正<br>迫切需要方卡回寄卡片时，应直接向对方地址邮寄卡片并附加SASE<br>通过卡片管理局寄出卡片并希望对方回卡时，应在卡片上注明PSE QSL DIRECT	迫切需要方卡回寄卡片时，应直接向对方地址邮寄卡片并附加SASE
LK1012 电台BD0XX听到某台的CW呼叫并欲与之联络，但只听清对方呼号的分区号和后缀为2MAX。正确的回呼方法规是：<br>R 2MAX DE BDOXX PSE UR PREFIX K<br>2MAX DE BDOXX PSE UR PREFIX AGN MY QSL OK PSE K<br>？2MAX DE BDOXX PSE AGN KN<br>QRZ？DE BD0XX PSE UR PREFIX AGN KN	？2MAX DE BDOXX PSE AGN KN
LK1013 电台BD0XX听到某台的SSB呼叫并欲与之联络，但只听清对方呼号的分区号和后缀为2MAX。正确的回呼方法规是：<br>2MAX, this is BDOXX. Your Surfix again, please. Over.<br>Roger. 2MAX, this is BDOXX. Your Surfix again, please. Over.<br>CQ 2MAX, this is BDOXX. Need your Surfix again. Over.<br>QRZ？ this is BDOXX. I’m standing by.	2MAX, this is BDOXX. Your Surfix again, please. Over.
LK1014 在下列种类的谐振回路中，通频带最窄的是：<br>松耦合高Q参差调谐回路<br>松耦合的高Q单调谐或同频双调谐回路<br>紧耦合高Q同频双调谐回路<br>松耦合低Q同频双调谐回路	松耦合的高Q单调谐或同频双调谐回路
LK1015 正弦交流信号通过下列电路时会产生高次谐波：<br>复杂电容电感网络<br>调谐在信号的整倍频上的谐振电路<br>二极管整流器或三极管开关放大器<br>复杂电阻网络	二极管整流器或三极管开关放大器
LK1016 电路分析经常用到理想运算放大器的概念。理想运算放大器是指：<br>开环放大倍数无穷大的放大器<br>输出电压幅度没有限制的放大器<br>没有电源消耗的放大器<br>内部噪声等于零的放大器	开环放大倍数无穷大的放大器
LK1017 在半导体三极管的基本放大电路中，电压增益最大的是：<br>共发射极放大电路<br>共基极放大电路<br>带负反馈的共发射极放大电路<br>共集电极放大电路	共发射极放大电路
LK1018 在半导体三极管的基本放大电路中，输入阻抗最高的是：<br>共基极放大电路<br>共集电极放大电路<br>共发射极放大电路<br>带正反馈的共发射极放大电路	共集电极放大电路
LK1019 在半导体三极管的基本放大电路中，输出阻抗最低的是：<br>共发射极放大电路<br>共基极放大电路<br>带正反馈的共发射极放大电路<br>共集电极放大电路	共集电极放大电路
LK1020 下列放大器电路中，电源效率最低的是：<br>甲类放大器<br>乙类放大器<br>丙类放大器<br>甲乙类放大器	甲类放大器
LK1021 下列放大器电路中，电源效率最高的是：<br>甲乙类放大器<br>甲类放大器<br>丙类放大器<br>乙类放大器	丙类放大器
LK1022 下列放大器电路中，波形失真最小的是：<br>甲类放大器<br>甲乙类放大器<br>丙类放大器<br>乙类放大器	甲类放大器
LK1023 下列放大器电路中，波形失真最大的是：<br>甲乙类放大器<br>甲类放大器<br>乙类放大器<br>丙类放大器	丙类放大器
LK1024 下列放大器电路中，最适宜用作音频大功率放大器的是：<br>甲类放大器<br>甲乙类放大器<br>丙类放大器<br>乙类放大器	甲乙类放大器
LK1025 下列放大器电路中，最适宜用作音频小信号放大器的是：<br>乙类放大器<br>甲乙类放大器<br>丙类放大器<br>甲类放大器	甲类放大器
LK1026 下列放大器电路中，最适宜用作CW射频功率放大器的是：<br>甲类放大器<br>乙类放大器<br>甲乙类放大器<br>丙类放大器	丙类放大器
LK1027 下列放大器电路中，最适宜用作FM射频功率放大器的是：<br>丙类放大器<br>甲类放大器<br>甲乙类放大器<br>乙类放大器	丙类放大器
LK1028 下列放大器电路中，最适宜用作SSB射频功率放大器的是：<br>丙类放大器<br>甲类放大器<br>接近乙类的甲乙类放大器<br>接近甲类的甲乙类放大器	接近乙类的甲乙类放大器
LK1029 单边带发信机中发信自动电平控制ALC的主要作用是：<br>实现天线电路阻抗的自动匹配<br>防止话筒过于灵敏造成的背景噪音<br>改善发信频率的稳定度<br>防止过驱动带来的调制失真	防止过驱动带来的调制失真
LK1030 业余电台发射单边带语音信号中，语音虽然基本正常，但操作员周围噪杂的声音很响，应该：<br>重新调整发信机的自动电平控制（ALC）<br>重新调整发射机天线电路的匹配<br>调低发射机的话筒增益<br>调低发射机的射频输出功率	调低发射机的话筒增益
LK1031 430MHz业余频段中留给业余卫星通信使用，话音及其他通信方式不应占用的频率段为：<br>433MHz至435MHz<br>435MHz至438MHz<br>438MHz至439MHz<br>432MHz至434MHz	435MHz至438MHz
LK1032 144MHz业余频段中留给业余卫星通信使用，话音及其他通信方式不应占用的频率段为：<br>144.2MHz至144.5MHz<br>145.4MHz至144.6MHz<br>144.8MHz至145MHz<br>145.8MHz至146MHz	145.8MHz至146MHz
LK1033 28MHz业余频段中留给业余卫星通信、话音及其他通信方式不应占用的频率段为：<br>28.7MHz至28.95MHz<br>29.15MHz至29.35MHz<br>29.3MMz至29.51MHz<br>28.3MHz至28.61MHz	29.3MMz至29.51MHz
LK1034 南北走向的水平极化偶极天线，中点馈电，通过特性阻抗为50欧的电缆连接到输入/输出阻抗为50欧的收发信机，通信对象在东西方向。选择天线长度的原则是：<br>只要电压驻波比达到最低，通信效果一定好<br>天线臂长为四分之一波长的奇数倍时，通信效果肯定最好<br>只要天线与工作频率谐振，通信效果一定好<br>天线臂长为四分之一波长的偶数倍时，通信效果肯定最好	天线臂长为四分之一波长的奇数倍时，通信效果肯定最好
LK1035 北京的水平极化半波长偶极天线，通信对象为纽约的业余电台。按电波的最短传输途径考虑，天线的最佳走向应大致为：<br>东偏南30度-西偏北30度<br>东-西<br>南-北<br>西偏南30度-东偏北30度	东-西
LK1036 14022KHz有很多电台争相报出自己的呼号，原来是想呼叫发射频率为14020KHz的某稀有台。如要加入对该稀有台的呼叫，应该：<br>守听14020KHz，在稀有台结束和其他电台联络或者呼叫CQ和QRZ时，在14022KHz快速准确地发送自己的呼号<br>在14022KHz不断发送自己的呼号<br>在14020KHz呼叫该稀有台<br>守听14020KHz，在稀有台结束和其他电台联络或者呼叫CQ和QRZ时，在14020KHz快速准确地发送自己的呼号	守听14020KHz，在稀有台结束和其他电台联络或者呼叫CQ和QRZ时，在14022KHz快速准确地发送自己的呼号
LK1037 业余卫星一般采用低轨道或者椭圆轨道设计，主要原因是：<br>增强地球吸引力以保持运转稳定<br>发射成本低<br>增加卫星转发器覆盖面积<br>卫星转发器功率可以增加	发射成本低
LK1038 在很多无线电和电子电路的旁路电容滤波电路中，经常将一大容量电容器与一小容量电容器 并联，这样的作用是：<br>增加电容器的总耐压指标<br>低频率由大电容负责，频率升高时大电容的引线电感不可忽略，则由小电容主要负责，以达到宽频带滤波效果<br>利用两个电容器容量相加的办法得到精确的容量<br>为防止大电容干涸失效，采用小电容增大保险系数	低频率由大电容负责，频率升高时大电容的引线电感不可忽略，则由小电容主要负责，以达到宽频带滤波效果
LK1039 如遇设备、电线或者电源引起失火，正确的处置为：<br>立即切断电源，使用二氧化碳灭火器灭火<br>立即切断电源，用水灭火<br>迅速起身逃离火场<br>立即切断电源，使用化学泡沫灭火器灭火	立即切断电源，使用二氧化碳灭火器灭火
LK1040 必须带电检修由市电供电的无线电设备时，应做到：<br>双脚与地绝缘，单手操作，另一只手通过触摸机壳或水管等途径良好接地<br>只要设备外壳良好接地，双脚是否与地绝缘、双手是否同时操作都没有关系<br>只要确保设备外壳与地绝缘，双脚是否与地绝缘、双手是否同时操作都没有关系<br>双脚与地绝缘，单手操作，另一只手不触摸机壳等任何与电路设备有关的金属物品	双脚与地绝缘，单手操作，另一只手不触摸机壳等任何与电路设备有关的金属物品
LK1041 如果收到国外寄来的QSL卡片中夹带有一张或多张IRC，应该：<br>不必确认联络的真实性，尽快通过邮局直接向对方地址寄出自己的QSL卡片<br>尽快检查电台日志确认联络的真实性，并通过国内的QSL卡片管理局寄出自己的QSL卡片<br>尽快检查电台日志确认联络的真实性，并通过邮局直接向对方地址寄出自己的QSL卡片<br>不必理会	尽快检查电台日志确认联络的真实性，并通过邮局直接向对方地址寄出自己的QSL卡片
LK1042 关于QSL卡片的正确用法是：<br>出于火腿互相帮助的目的，虽然对方没有联络到自己，也可以发去确认联络的QSL卡片<br>空白QSL卡片可以当做照片或者名片，任意赠送、交换、散发<br>如果在联络中没有听清对方呼号，可以在寄发QSL卡片的对方台名栏中填写对方操作员姓名<br>不是作为联络或收听证明而交换QSL卡片时，应填上“Eye ball QSO”等有关说明，不应赠送空白卡片	不是作为联络或收听证明而交换QSL卡片时，应填上“Eye ball QSO”等有关说明，不应赠送空白卡片
LK1043 两手分别接触电压有效值相同但频率不同的电路两端时，对人体生命安全威胁由大到小的排序为：<br>UHF射频交流电、HF射频交流电、工频交流电<br>HF射频交流电、UHF射频交流电、工频交流电<br>工频交流电、HF射频交流电、UHF射频交流电<br>HF射频交流电、工频交流电、UHF射频交流电	工频交流电、HF射频交流电、UHF射频交流电
LK1044 无线电发信机在无调制情况下，在一个射频周期内供给天线馈线的平均功率称为：<br>平均功率<br>峰包功率<br>载波功率<br>无用功率	载波功率
LK1045 如果发射机在不同工作模式时最大射频输出功率相同，无语音调制时，实际射频输出由大到小的排序为：<br>SSB，AM，FM<br>SSB，FM，AM<br>FM，AM，SSB<br>AM，SSB，FM	FM，AM，SSB
LK1046 业余电台之间进行通信，必须相互正确发送和接收的信息为：<br>本台呼号、信号报告、QTH<br>本台呼号、对方呼号、QTH<br>本台呼号、对方呼号、信号报告<br>对方呼号、信号报告、设备情况	本台呼号、对方呼号、信号报告
LK1047 做EME通信试验最好的时机是：<br>月亮处于近地点<br>太阳黑子数高<br>通信两端天气都好<br>满月	月亮处于近地点
LK1048 当最高可用频率（MUF）为20MHz时，具有较大DX通联机会的业余频段是：<br>21MHz<br>18MHz<br>14MHz<br>24MHz	18MHz
LK1049 太阳耀斑引起的电离层扰动（SID）对短波通信的影响是：<br>地球黑夜一面受到的影响会超过白昼面<br>卫星通信受到的影响会超过地面直射波通信<br>高纬度的传播路径影响会超过低纬度<br>低频率受到的影响超过高频率	低频率受到的影响超过高频率
LK1050 下列调制得到的信号幅度恒定不变：<br>单边带幅度调制SSB<br>幅度调制AM<br>移频键控FSK<br>幅度键控调制ASK	移频键控FSK
LK1051 下列调制得到的信号幅度恒定不变：<br>单边带幅度调制SSB<br>幅度调制AM<br>幅度键控调制ASK<br>频率调制FM	频率调制FM
LK1052 下列调制得到的信号幅度恒定不变：<br>幅度调制AM<br>幅度键控调制ASK<br>单边带幅度调制SSB<br>相位调制PM	相位调制PM
LK1053 下列调制得到的信号幅度恒定不变：<br>单边带幅度调制SSB<br>幅度调制AM<br>幅度键控调制ASK<br>移相键控调制PSK	移相键控调制PSK
LK1054 下列调制得到的信号周期恒定不变：<br>相位调制PM<br>频率键控调制FSK<br>单边带幅度调制SSB<br>频率调制FM	相位调制PM
LK1055 下列调制得到的信号中载频分量幅度恒定不变：<br>频率调制FM<br>幅度调制AM<br>载波抑制单边带幅度调制SSB<br>频率键控调制FSK	幅度调制AM
LK1056 信号经过下列调制后，频带宽度可能会大于原有值：<br>单边带幅度调制SSB<br>幅度键控调制ASK<br>频率调制FM<br>幅度调制AM	频率调制FM
LK1057 对称半波振子每一臂的长度为波长的：<br>2倍<br>1/4倍<br>4倍<br>1/2倍	1/4倍
LK1058 无线电波按传播方式可主要分为下列种类：<br>正弦波、方波、三角波等<br>地面波、天波、空间波、散射波等<br>长波、中波、短波、超短波、微波等<br>调幅波、调频波、调相波等	地面波、天波、空间波、散射波等
LK1059 HF频段远距离通信主要依靠下列传播方式：<br>业余卫星转发<br>中继台网转发<br>对流层散射传播<br>电离层反射	电离层反射
LK1060 无线电波在自由空间中的传播路径损耗遵循下列规律：<br>与距离的平方成正比，与频率无关<br>与距离的平方成正比，与频率的平方成反比，<br>与距离的平方成正比，与频率的平方成正比<br>与距离成正比，与频率的平方成正比	与距离的平方成正比，与频率的平方成正比
LK1061 “静寂区”或者“越距”是指：<br>HF频段天波和地波都传播不到的中间区域<br>VHF/UHF频段视距范围内但受障碍物阻挡电波传播不到的区域<br>VHF/UHF频段超过视距电波传播不到的区域<br>卫星通信中覆盖区以外电波传播不到的区域	HF频段天波和地波都传播不到的中间区域
LK1062 以dBd为单位的天线增益则是指：<br>最大辐射方向辐射功率密度与1/4波长垂直接地天线水平方向辐射功率密度之比的dB值<br>最大辐射方向辐射功率密度与理想点源天线最大辐射方向辐射功率密度之比的dB值<br>最大辐射方向辐射功率密度与最小辐射方向辐射功率密度之比的dB值<br>最大辐射方向辐射功率密度与半波长振子最大辐射方向辐射功率密度之比的dB值	最大辐射方向辐射功率密度与半波长振子最大辐射方向辐射功率密度之比的dB值
LK1063 以dBi为单位的天线增益则是指：<br>最大辐射方向辐射功率密度与最小辐射方向辐射功率密度之比的dB值<br>最大辐射方向辐射功率密度与1/4波长垂直接地天线水平方向辐射功率密度之比的dB值<br>最大辐射方向辐射功率密度与理想点源天线最大辐射方向辐射功率密度之比的dB值<br>最大辐射方向辐射功率密度与半波长振子最大辐射方向辐射功率密度之比的dB值	最大辐射方向辐射功率密度与理想点源天线最大辐射方向辐射功率密度之比的dB值
LK1064 家用微波炉一般的工作频带是：<br>SHF（超高频）<br>UHF（特高频）<br>EHF（极高频）<br>VHF（甚高频）	UHF（特高频）
LK1065 在相距不远的两点接收同一个远方信号，信号强度发生很大差别，且差别随两点间距离的增大呈周期性变化。这是因为：<br>地磁影响影响<br>多径传播，各路径到达的信号相位延迟不同而互相干涉<br>大气扰动影响<br>发射机到两接收点传播距离不同造成传播路径衰耗不同	多径传播，各路径到达的信号相位延迟不同而互相干涉
LK1066 无线电接收机的灵敏度是指：<br>接收机正常工作所需的最小电源功率<br>接收机正常工作所需的最大电源电压<br>接收机正常工作所需的最小输入信号强度<br>接收机正常工作所需的最大输入信号强度	接收机正常工作所需的最小输入信号强度
LK1067 地波是沿地面传播的无线电波，其衰减因子取决于：<br>电波频率、发射功率和天线增益<br>天线高度、发射功率和调制方式<br>电波频率、地面导电率和传播距离<br>电波频率、太阳活动情况和地磁活动情况	电波频率、地面导电率和传播距离
LK1068 决定超短波视距传播距离极限的主要因素是：<br>发射天线和接收天线离海平面的绝对高度值<br>发射天线和接收天线的增益<br>发射天线和接收天线离地面的相对高度值<br>发射天线和接收天线离地面的相对于波长的高度系数，即离地高度除以波长	发射天线和接收天线离地面的相对高度值
LK1069 在导电良好的地面上，决定短波天线辐射仰角的主要参数是：<br>天线离海平面的绝对高度<br>天线导线或者八木天线主梁与地面之间的夹角<br>天线离地面的相对于波长的高度，即离地高度除以波长<br>天线的绝对高度，与波长无关	天线离地面的相对于波长的高度，即离地高度除以波长
LK1070 天线的接收单元直接连到适当的放大器就构成有源天线。对于同样结构的天线，使用有源接收天线的目的是：<br>提高天线输出的信号电平，以克服传输线路和接收机前级固有噪声的影响<br>展宽天线的工作带宽<br>提高天线接收到的有用信号电平，以克服天线周围环境的外部噪声影响<br>提高天线接收到的有用信号电平，以克服临近频道电台信号的干扰	提高天线输出的信号电平，以克服传输线路和接收机前级固有噪声的影响
LK1071 法规要求业余电台在通信建立及结束时主动发送本台呼号。允许用发送呼号的一部分来代替发送完整呼号的情况是：<br>在任何情况下都必须用完整呼号作为电台标识<br>在熟悉的友台之间呼叫可以仅使用呼号后缀作为电台标识<br>在HF频段进行国内呼叫时可以仅使用呼号后缀作为电台标识<br>在VHF/UHF频段进行本地呼叫时可以仅使用呼号后缀作为电台标识	在任何情况下都必须用完整呼号作为电台标识
LK1072 在实际通信中，是否可以把本台呼号的地区号码加后缀视作《业余电台管理办法》所说的“本台呼号”？<br>在VHF/UHF频段进行本地呼叫和联络时可以把不完整呼号视作“呼号”<br>不可以。不完整呼号不具有呼号的属性，不能视作呼号<br>在HF频段进行国内呼叫和联络时可以把不完整呼号视作“呼号”<br>在熟悉的友台之间呼叫和联络中可以把不完整呼号视作“呼号”	不可以。不完整呼号不具有呼号的属性，不能视作呼号
LK1073 以下呼号前缀中，所属CQ分区与埃及相同的是：<br> 5X<br> 5W<br>5A<br> 5T	5A
LK1074 申请WAS奖状时，不能用以下哪个呼号的卡片作为通联证明卡片：<br>AC6HY<br>VA3EJ<br>KC1XX<br>N8DX	VA3EJ
LK1075 申请5BWAZ奖状，至少要提交多少个不同分区的卡片：<br>198<br>200<br>40<br>199	198
LK1076 对于中国HAM来说，属于既稀有又困难的是：<br>KP5A<br>VK0HR<br>P5/4L4FN<br>KP1A	KP5A
LK1077 在CQWW系列比赛中，哪些组别不能使用CW SKIMMER作为辅助工具使用：<br>SOAB-A<br>MS<br>SOAB<br>SOSB-20	SOAB
LK1078 DX SUMMIT上出现这样一行：“PY2SS 28005.3 KH6/N6GQ Simplex, fading signal in SA 2040 15 Feb 2012”，以下描述正确的是：<br>巴西电台收听关岛电台效果很好<br>巴西电台收听夏威夷电台效果不好<br>巴西电台收听夏威夷电台效果很好<br>巴西电台收听关岛电台效果不好	巴西电台收听夏威夷电台效果不好
LK1079 BG1DOB在IARU HF World Championship竞赛中通联到某个电台，信号报告为599JARL，那么这个电台的呼号有可能是：<br>DA1HQ<br>8N1HQ<br>B4HQ<br>BA4RF	8N1HQ
LK1080 DX SUMMIT上出现这样一行：JA2WS 14009.6 E51WWA Calling CQ, no takers, Cook Is0052 14 Feb 2008。其正确的意思是：<br>E51WWA在库克岛，呼叫CQ，没人应答<br>JA2WS在库克岛，呼叫CQ，很多人应答<br>JA2WS 在库克岛，呼叫CQ，没人应答<br>E51WWA在库克岛，呼叫CQ，很多人应答	E51WWA在库克岛，呼叫CQ，没人应答
LK1081 北京20岁女大学生参加IARU HF World Championship单人组比赛，她发给别人的信号报告有可能是：<br>59001<br>5924<br>5944<br>5900	5944
LK1082 北京20岁女大学生参加ALL ASIAN SSB单人组比赛，她发给别人的信号报告有可能是：<br>5924<br>5944<br>59001<br>5900	5900
LK1083 北京20岁女大学生参加CQ WW CW竞赛，她发给别人的信号报告有可能是：<br>59924<br>59900<br>59944<br>599001	59924
LK1084 卫星和6米的WAZ奖状需要申请者提交至少多少个区的QSL卡片：<br>25<br>40<br>30<br>35	25
LK1085 160m的WAZ奖状需要申请者提交至少多少个区的QSL卡片：<br>25<br>40<br>35<br>30	25
LK1086 进行传播预测时，太阳通量的值最低可以取为50左右，最高可以取为：<br>300<br>280<br>200<br>250	300
LK1087 反映地磁活动的程度有A指数和K指数，K指数是一个0到___之间变化的数字：<br>7<br>9<br>6<br>8	9
LK1088 通常的成品收发信机上都有AGC功能，下面那种用法是正确的？<br>通常在SSB模式时，使用慢速或中速 AGC<br>将AGC 设为AUTO ，可以适应各种调制模式的接收<br>FM 模式使用快速 AGC<br>在接收小信号且有临频大信号干扰时关闭	通常在SSB模式时，使用慢速或中速 AGC
LK1089 3V、4X、5A、6Y字头所代表的国家是：<br>Guinea、Israel、Fiji Islands、Senegal<br>Tunis、Israel、Libya、Jamaica<br>Jamaica、Israel、Libya、Senegal<br>Libya、Israel、Jamaica、Guinea	Tunis、Israel、Libya、Jamaica
LK1090 以北京为中心与DXCC实体3X、HZ、G、OE之间的大圆距离由远及近的排序为：<br>G、OE、3X、HZ<br>3X、G、OE、HZ<br>3X、HZ、OE、G<br>HZ、OE、3X、G	3X、G、OE、HZ
LK1091 某业余电台在参加比赛，对方报来的交换信息是599CN，这个业余电台参加的比赛是：<br>ALL ASIAN DX CONTEST<br>IARU ARRL 160M CONTEST<br>CQWW WPX<br>CQWW CW	IARU ARRL 160M CONTEST
LK1092 当最高可用频率（MUF）为20MHz时哪个波段具有较大的成功通联机会？<br>12m<br>20m<br>15m<br>17m	17m
LK1093 IOTA活动在20米波段SSB模式和CW模式常用的频率是多少？<br>14.260 MHz / 14.060 MHz<br>14.190 MHz / 14. 040 MHz<br>14.260 MHz / 14.040 MHz<br>14.190 MHz / 14.060 MHz	14.260 MHz / 14.040 MHz
LK1094 NCDXF信标台在20米、17米、15米和10米波段的的频率是？<br>14.100 / 18.110 /21.150 / 28.100 MHz<br>14.100 / 18.100 / 21.150 /28.200 MHz<br>14.100 / 18.110 / 21.150 / 28.200 MHz<br>14.100 / 18.150 /21.150 / 28.200 MHz	14.100 / 18.110 / 21.150 / 28.200 MHz
LK1095 按照竞赛惯例，以下频率中不能用于IOTA竞赛的有？<br>3560-3600 kHz<br>14300-14350 kHz<br>14060-14125 kHz<br>7040-7060 kHz	3560-3600 kHz
LK1096 如果你知道另一个电台的呼号，想要在中继上呼叫他，你应该怎么做？<br>等待，直到你要呼叫的电台呼叫CQ后，立刻回答他<br>呼叫“CQ”三次，然后说出对方的呼号<br>呼叫对方的呼号，并报出自己的呼号<br>呼叫“break break”，然后说出对方的呼号	呼叫对方的呼号，并报出自己的呼号
LK1097 如何回答一个CQ呼叫？<br>说：“CQ”，并报出对方的呼号<br>先报出对方的呼号，再报出自己的呼号<br>先报出自己的呼号，再报出对方的呼号<br>先给出信号报告，再报出自己的呼号	先报出对方的呼号，再报出自己的呼号
LK1098 当一部电台在呼叫CQ时，他的意思是？<br>此电台正在测试天线，不需要任何电台回答这个呼叫<br>呼叫重庆的电台<br>只有被呼叫的电台可以回答，其他人不能回答<br>非特指地呼叫任何一部电台	非特指地呼叫任何一部电台
LK1099 调频发射机在发射的语音信号上附加一个人耳听不到的低频音频，用来打开接收机的静噪。这一技术的常用名词是：<br>单音频脉冲<br>CTCSS<br>载波静噪<br>DTMF	CTCSS
LK1100 下列哪一项决定了FM信号的频偏？<br>取决于被调制信号与载波之间的相位角关系<br>取决于被调制信号的幅度<br>取决于被调制信号的频率<br>同时取决于被调制信号的频率和幅度	取决于被调制信号的幅度
LK1101 如果别人报告说你的发射干扰了相邻频率的通信，此时你应当做的是：<br>换用另一种调制模式工作<br>加大发射功率<br>检查发射机的频率指示是否准确、发射机的杂散发射指标是否合格<br>将这种情况通知你的设备制造商	检查发射机的频率指示是否准确、发射机的杂散发射指标是否合格
LK1102 如果其他电台报告你在2米波段的信号刚才非常强，但是突然变弱或不可辨，这时你应当怎么做？<br>打开哑音发射功能<br>请对方电台调整自己的静噪设置<br>稍稍移动一下自己的位置，有时信号无规律反射造成的多径效应可能导致失真<br>将你电台中的镍氢电池换成锂电池	稍稍移动一下自己的位置，有时信号无规律反射造成的多径效应可能导致失真
LK1103 电磁波在地球与电离层间反射后，通常会发生什么？<br>电磁波的频率被随机增加或减少一定的值<br>频率在30MHz以上的电磁波信号会在每一次反射后变得更强<br>信号的极化方向发生随机改变<br>每一次反射都会使边带倒转	信号的极化方向发生随机改变
LK1104 多径传播对UHF波段或VHF波段数据通信的影响是：<br>随着传播路径的增加，接收到的数据速率会线性地减小<br>随着传播路径的增加，数据通信速率会线性地增加<br>可能使误码率增大<br>如果使用FM方式调制的话，不会观察到任何反常现象	可能使误码率增大
LK1105 大气层中的哪一部分使得无线电信号可以在全世界范围内传播？<br>磁层<br>电离层<br>平流层<br>对流层	电离层
LK1106 在一个周期内，电磁波走过一定的距离，这个距离叫做：<br>波速<br>波长<br>波展<br>波形	波长
LK1107 下面哪一个术语可以用来描述交流电每秒改变方向的次数？<br>速率<br>波长<br>频率<br>脉率	频率
LK1108 无线电波的两个组成部分是？<br>直流和交流<br>电压和电流<br>电离辐射和非电离辐射<br>电场和磁场	电场和磁场
LK1109 无线电波的传播速度有多快？<br>和它的波长成反比例关系<br>速度随着频率的增加而增加<br>和光速一样<br>和音速一样	和光速一样
LK1110 无线电波的频率和它的波长有什么样的关系？<br>该电磁波的波长取决于信号所占的带宽<br>波长与频率之间没有固定的联系<br>如果频率增加，则波长变长<br>如果频率增加，则波长变短	如果频率增加，则波长变短
LK1111 在已知电磁波频率的情况下，下面哪一种方法可以用来计算它的波长？<br>使用频率的赫兹数（Hz）乘以300可以得到以米为单位的波长<br>将频率的赫兹数（Hz）除以300可以得到以米为单位的波长<br>使用300除以频率的兆赫数（MHz）可以得到以米为单位的波长<br>将频率的兆赫数（MHz）除以300可以得到以米为单位的波长	使用300除以频率的兆赫数（MHz）可以得到以米为单位的波长
LK1112 VHF段的频率范围是多少？<br>300到3000kHz<br>300到3000MHz<br>30到300kHz<br>30到300MHz	30到300MHz
LK1113 UHF段的频率范围是多少？<br>300到3000MHz<br>30到300MHz<br>300到3000kHz<br>30到300kHz	300到3000MHz
LK1114 HF段的频率范围是多少？<br>300到3,000kHz<br>30到300MHz<br>300到3,000MHz<br>3到30MHz	3到30MHz
LK1115 在自由空间中，无线电波的速度约是多少？<br>3000千米/每秒<br>300000000米/每秒<br>18600英里/每小时<br>300000英里/每小时	300000000米/每秒
LK1116 如果你收到了一个从上千公里以外的距离传播过来的VHF信号，最可能的原因是：<br>信号经过了地下传输过来<br>信号被附近的雷雨区反射过来<br>信号被突发E电离层反射过来<br>信号经过了宇宙的反射	信号被突发E电离层反射过来
LK1117 在10米、6米、2米波段经常能够接收到的“超视距传播”信号与下列哪种传播现象密切相关？<br>突发E电离层<br>灰线传播<br>D层的吸收<br>流星余迹反向散射	突发E电离层
LK1118 在通常情况下，下列哪种传播模式可能使500公里左右范围的VHF和UHF超视距通信变得可行？<br>对流层散射<br>F2层折射<br>D层折射<br>法拉第旋转	对流层散射
LK1119 哪一个业余无线电波段最适合流星余迹散射通信？<br>6米<br>70厘米<br>2米<br>10米	6米
LK1120 是什么导致了对流层的大气波导传播？<br>飓风或龙卷风导致的上升气流<br>雷暴时闪电的放电<br>大气高空逆温<br>太阳黑子和太阳耀斑	大气高空逆温
LK1121 通常来说，对于10米波段长距离通信的最好的时候是？<br>夜间<br>在太阳通量很低的任何时候<br>当有日冕物质抛射的时候<br>白天	白天
LK1122 下列哪种设备可以用来代替普通的扬声器，可在嘈杂的环境中更好地抄收语音信号？<br>视频显示器<br>耳机<br>低通滤波器<br>吊杆话筒	耳机
LK1123 滤去杂散发射的滤波器应该安装在什么地方？<br>电台的电源处<br>发信机和天线之间<br>话筒上<br>收信机和发信机之间	发信机和天线之间
LK1124 在解决电视接收机被附近的144MHz业余电台的过载干扰问题的时候，应当先尝试什么措施？<br>在电视接收机的天线端子前安装144MHz带阻滤波器<br>在业余电台的射频输出端安装144MHz带阻滤波器<br>在电视接收机的天线端子前安装144MHz带通波器<br>在业余电台的射频输出端安装144MHz带通滤波器	在电视接收机的天线端子前安装144MHz带阻滤波器
LK1125 下列哪一种导体最适合射频接地使用？<br>圆形多股线<br>镀银软铜丝编织扁带<br>双绞线<br>圆形铜包钢单股线	镀银软铜丝编织扁带
LK1126 安装哪个部件可以减少在音频同轴电缆屏蔽层外皮中的感应射频电流？<br>在电缆外面套铁氧体磁环<br>在电缆前端前置放大器<br>在电缆芯线中串联低通滤波器<br>在电缆芯线中串联带通滤波器	在电缆外面套铁氧体磁环
LK1127 在汽车上安装的移动电台中能听到的随着引擎转速变化的高频啸叫声的来源是？<br>发电机<br>防抱死刹车装置的控制器<br>电动油泵<br>火花塞系统	发电机
LK1128 移动车载台的直流电源负极应当接在哪里？<br>连接在天线座上<br>可以连接在汽车的任意的金属部分<br>连接在电池的负极或发动机的接地带<br>连接在固定住电台的挂置架上	连接在电池的负极或发动机的接地带
LK1129 如果将发射机的话筒增益设置得过高会导致什么问题？<br>驻波比会增加<br>发射机的频率会变得不稳定<br>发射机的输出功率将会特别高<br>发射机发射的信号可能会失真	发射机发射的信号可能会失真
LK1130 收发信机中的静噪控制的目的是什么？<br>可以进行自动增益控制<br>使接收机的输出音量调到最大<br>在没有信号的情况下，关闭音频输出，使其不会输出噪音。<br>控制发射机的输出功率	在没有信号的情况下，关闭音频输出，使其不会输出噪音。
LK1131 下列哪种方式可以让你快速切换到一个你经常使用的频率？<br>打开哑音输出<br>关闭哑音输出<br>将这个频率作为一个频道存储在电台中<br>使用快速扫描模式来切换到那个频率	将这个频率作为一个频道存储在电台中
LK1132 下列哪一项可以有效减小火花塞干扰？<br>降低静噪（SQL）阀值<br>调节电台的RIT旋钮<br>打开电台的抑噪（NB）功能<br>将频率稍稍偏离一些	打开电台的抑噪（NB）功能
LK1133 电台的下列哪一项控制功能可以使听起来音调偏高或偏低的SSB语音信号变得正常？<br>RIT功能<br>哑音静噪<br>自动增益控制或限幅器<br>带宽选择	RIT功能
LK1134 电流使用下列哪一个单位来衡量？<br>瓦特<br>安培<br>伏特<br>欧姆	安培
LK1135 电功率使用如下哪一个单位来衡量？<br>瓦特<br>欧姆<br>安培<br>伏特	瓦特
LK1136 只向一个方向流动的电流叫做什么？<br>常流<br>直流<br>平流<br>交流	直流
LK1137 移动车载电台通常使用的电源电压是？<br>约240伏特<br>约120伏特<br>约30伏特<br>约12伏特	约12伏特
LK1138 下列哪一项是电的良导体？<br>铜<br>橡胶<br>木材<br>玻璃	铜
LK1139 下列哪一项是电的良好绝缘体？<br>玻璃<br>铝<br>汞<br>铜	玻璃
LK1140 电能消耗的速率叫做什么？<br>电流<br>电功率<br>电阻<br>电压	电功率
LK1141 能够以电场形式储存能量的元件是什么？<br>电感<br>压敏元件<br>电阻<br>电容	电容
LK1142 能够以磁场形式储存能量的元件是什么？<br>电磁铁<br>电感<br>电容<br>电阻	电感
LK1143 下列哪一个缩写经常在无线电工程文章中用来代表各种类型的无线电波？<br>VHF<br>RF<br>HF<br>AF	RF
LK1144 在空间中传播的电磁波，一般被叫做什么？<br>无线电波<br>声波<br>压力波<br>重力波	无线电波
LK1145 在直流电路中，用来阻碍电流流动的元件是？<br>电压表<br>电感<br>变压器<br>电阻	电阻
LK1146 下列哪一个元件经常用来实现音量调节的功能？<br>功率电阻<br>电位器<br>变压器<br>定值电阻	电位器
LK1147 电位器控制什么电学物理量？<br>电阻<br>电容<br>场强<br>电感	电阻
LK1148 哪一种电子元件由两个或多个使用绝缘材料分离开的片状导体组成？<br>电容<br>电阻<br>电位器<br>振荡器	电容
LK1149 哪一种电子元件一般由线圈组成？<br>二极管<br>电感<br>开关<br>电容	电感
LK1150 哪一种电子元件用来接通或切断电路？<br>可变电阻<br>电感<br>齐纳二极管<br>开关	开关
LK1151 下列哪一项可以在电路电流严重过载时保护电路不受损坏？<br>电感<br>熔断器<br>电容<br>屏蔽层	熔断器
LK1152 一个充满电的镍镉电池的标称电压是多少？<br>2.2伏<br>1.0伏<br>1.2伏<br>1.5伏	1.2伏
LK1153 一个新的干电池的标称电压是多少？<br>1.5伏<br>2.2伏<br>1.0伏<br>1.2伏	1.5伏
LK1154 下列哪一种电池不能充电？<br>铅酸电池<br>锂离子电池<br>镍镉电池<br>碱性电池	碱性电池
LK1155 下列哪一种元器件可以用一个较小的电流来控制较大的电流？<br>晶体管<br>电阻<br>电感<br>电容	晶体管
LK1156 下列哪一种元器件只允许单方向的电流流动？<br>稳压元件<br>熔断器<br>电阻<br>二极管	二极管
LK1157 下列哪一种元器件既可以当作电子开关又可以当作放大器使用？<br>晶体管<br>电位器<br>单刀双掷开关<br>电压表	晶体管
LK1158 下列哪一种元器件由三层半导体材料制作而成？<br>三极电子管<br>五栅变频管<br>发电机<br>双极型晶体管	双极型晶体管
LK1159 下列哪一种元器件可以放大信号？<br>可变电阻<br>多芯电池<br>电解电容<br>晶体管	晶体管
LK1160 通常如何从外表识别半导体二极管的负极？<br>负极上通常标有“负极”字样<br>负极上通常标有星号“*”<br>负极上通常标有字母“C”<br>靠近负极的元件表面上通常印有环线标记	靠近负极的元件表面上通常印有环线标记
LK1161 二极管的两个电极分别叫什么？<br>正极和负极<br>源极和漏极<br>门极和基极<br>加极和减极	正极和负极
LK1162 LED是什么的缩写？<br>阴极射线管<br>发光二极管<br>场效应管<br>液晶显示	发光二极管
LK1163 LCD是什么的缩写？<br>液晶显示器<br>阴极射线管<br>场效应管<br>发光二极管	液晶显示器
LK1164 哪一种半导体器件拥有“发射极”？<br>双极型晶体管<br>硅二极管<br>场效应管<br>桥式整流器	双极型晶体管
LK1165 哪一种半导体器件拥有“栅极”？<br>硅二极管<br>桥式整流器<br>场效应管<br>双极型晶体管	场效应管
LK1166 下列哪一个名字用来描述晶体管放大信号的能力？<br>前向电阻<br>前向压降<br>导通电阻<br>增益	增益
LK1167 下列哪一项设备可以把交变电流变成变化的直流？<br>反射器<br>整流器<br>变压器<br>放大器	整流器
LK1168 继电器的功能可以描述为：<br>一个光学传感器<br>由电磁铁控制的开关<br>由电流控制的放大器<br>无线电转发设备	由电磁铁控制的开关
LK1169 下列部件中经常被用来把220伏的市电转换成更低电压交流电的是：<br>晶体管<br>变压器<br>二极管<br>可变电容器	变压器
LK1170 下列器件中能够当做指示灯使用的是：<br>FET<br>LED<br>齐纳二极管<br>双极型晶体管	LED
LK1171 下列哪一项和电感一起使用，可以制作一个谐振电路？<br>电位器<br>电容<br>电阻<br>齐纳二极管	电容
LK1172 集成电路是指：<br>将一个电路的大量元器件集合于一个单晶片上所制成的器件<br>多极继电器<br>变压器<br>把多个电阻或电容元件堆积在一起	将一个电路的大量元器件集合于一个单晶片上所制成的器件
LK1173 射频同轴电缆在业余电台中的主要用处是？<br>将无线电信号从发射机传送到天线<br>将信号从TNC传送到电脑<br>用来遮蔽天线塔上的支杆，管子等柱状物体<br>将电能从汽车的电池输送到移动车载电台	将无线电信号从发射机传送到天线
LK1174 乘积检波器的作用是什么？<br>解调FM信号<br>用来给调相信号检波<br>用来给CW或SSB信号检波<br>将语音信号从背景噪声中分离开来	用来给CW或SSB信号检波
LK1175 超外差式接收机中混频器的作用是？<br>将几个电台的信号混合在一起<br>将电台连接到一些辅助设备上，如TNC<br>阻止通带以外不必要的信号<br>将接收到的信号转换到中频	将接收到的信号转换到中频
LK1176 下列哪一项可以解调FM信号？<br>鉴频器<br>反相器<br>乘积检波器<br>限幅器	鉴频器
LK1177 下列哪一项术语表述了接收机区分不同信号的能力？<br>灵敏度<br>选择性<br>扫描速度<br>本底噪声	选择性
LK1178 射频前置放大器通常安装在什么地方？<br>在天线和接收机之间<br>在接收机音频输出处<br>在发射机功放的后面<br>在发射机和天调之间	在天线和接收机之间
LK1179 如果别的业余电台报告说你的手持电台发射的FM信号频偏过大，这时你应当怎么做？<br>用更大的声音对着麦克风说话<br>说话时距离麦克风稍远一些<br>让手持电台冷却一会儿<br>调到更大的功率档位	说话时距离麦克风稍远一些
LK1180 接收机“过载”通常是指：<br>输入信号过于强大，以致导致机内产生附加干扰<br>接收机电源的电压太高了<br>由于接收机的音量调节得过大而导致的附加干扰<br>接收机消耗的电流太大了	输入信号过于强大，以致导致机内产生附加干扰
LK1181 一般来说，如果要解决发射机对附近有线电话的干扰，最先做的应当是：<br>在发射机射频输出端安装高通滤波器<br>在发射机射频输出端安装低通滤波器<br>在有线电话进线处安装射频滤波器<br>改善发射机的接地情况	在有线电话进线处安装射频滤波器
LK1182 如果对方报告你的调频电台发射的信号听起来失真严重、可辨度差，可能的原因是：<br>电台的发射频率不准确<br>电台的电源电压不足<br>电台所处的位置不好<br>三项都可能	三项都可能
LK1183 假负载的主要作用是？<br>防止发射机过调制<br>改善天线的辐射效率<br>在测试设备时不让无线电信号真正地发射出去<br>增强接收机的信噪比	在测试设备时不让无线电信号真正地发射出去
LK1184 下列哪一个设备可以用来测定天线当前的谐振频率？<br>频率计数器<br>电子管电压表<br>天线分析仪<br>品质因数计	天线分析仪
LK1185 在业余无线电通信中，“驻波比”通常用来衡量：<br>传输线的制造质量<br>电台接地的质量<br>发射机的能效比<br>负载与传输线的匹配质量	负载与传输线的匹配质量
LK1186 天线与馈线完美匹配时，在驻波表中显示的驻波比是？<br>0<br>1:1<br>1:3<br>2:1	1:1
LK1187 如果在驻波表上读到了4:1，这意味着？<br>良好的阻抗匹配<br>天线的增益是4dB<br>阻抗匹配得不好<br>天线有4dB的损失	阻抗匹配得不好
LK1188 馈线中的功率损耗会？<br>传回你的发射机并可能导致损害<br>使你的信号失真<br>变成热量<br>使驻波比增加	变成热量
LK1189 导致同轴电缆损害的最常见的原因是什么？<br>电缆受潮<br>伽马射线<br>速度因子超过了1<br>过载	电缆受潮
LK1190 为什么要求同轴电缆的外皮能抵挡紫外线？<br>紫外线和射频信号会混合在一起导致干扰<br>紫外线会使电缆外皮中的功率损耗加大<br>这样就可以减少谐波<br>紫外线能破坏电缆的外皮，使水分渗入	紫外线能破坏电缆的外皮，使水分渗入
LK1191 和固体电介质同轴电缆相比，空气电介质同轴电缆的劣势是什么？<br>空气电介质电缆不能在冰点以下使用<br>空气电介质电缆的每米损耗更大<br>空气电介质电缆不能用于VHF或UHF段<br>空气电介质电缆要采取特别的手段来防止水分进入电缆	空气电介质电缆要采取特别的手段来防止水分进入电缆
LK1192 如何把一个电压表正确地连接至电路？<br>串联至电路中<br>与电路同相连接<br>正交至电路中<br>并联至电路中	并联至电路中
LK1193 电流表通常要怎样连接至电路？<br>并联至电路中<br>串联至电路中<br>与电路同相连接<br>正交至电路中	串联至电路中
LK1194 哪一种设备被用来测量电阻？<br>频谱分析仪<br>天线分析仪<br>示波器<br>欧姆表	欧姆表
LK1195 下列哪一种行为有可能损坏万用表？<br>没有让待测量设备适当地预热<br>把万用表设在“毫安”挡放置了一夜<br>在电阻挡试图测量电压<br>在大电压量程下测量一个非常小的电压	在电阻挡试图测量电压
LK1196 我们经常使用万用表测量以下哪些物理量？<br>阻抗和电抗<br>电压和电阻<br>信号的强度和噪音<br>驻波比和射频功率	电压和电阻
LK1197 哪一种焊锡材料比较适用于无线电制作和修理？<br>松香芯焊锡丝<br>银焊锡丝<br>酸心焊锡丝<br>铝焊锡丝	松香芯焊锡丝
LK1198 如果用欧姆表测量一个电路，最开始欧姆表显示阻抗很小，接着显示电阻变得越来越大，这是因为：<br>该电路是一个张弛振荡电路<br>这个电路两端可能存在一个很大的电容<br>这个电路两端可能存在一个很大的电感<br>欧姆表有了故障	这个电路两端可能存在一个很大的电容
LK1199 在使用欧姆表测量一个电路的某两个端点间电阻值之前，要先注意什么？<br>确保电路在正常的频率下工作<br>确保电路没有连接至电源<br>确保电路已经正常接地<br>确保电路已接通了正常工作时需要的电源	确保电路没有连接至电源
LK1200 下列哪一种可以归入调幅通信？<br>单边带通信<br>相移键控<br>扩频通信<br>封包通信	单边带通信
LK1201 在VHF封包通信中，哪一种调制模式被广泛使用？<br>扩频通信<br>AM<br>FM<br>SSB	FM
LK1202 以下哪种语音调制常被用于长距离弱信号的VHF或UHF联络？<br>SSB<br>FM<br>AM<br>PM	SSB
LK1203 下列哪种调制被VHF和UHF业余电台本地通信广泛使用？<br>AM<br>FM<br>SSB<br>PSK	FM
LK1204 下列发射模式中拥有最窄带宽的是：<br>调频话音<br>单边带话音<br>CW<br>慢扫描电视	CW
LK1205 28MHz和VHF、UHF频段的业余单边带通信通常使用哪一种边带方式？<br>上边带<br>倒转边带<br>下边带<br>抑制边带	上边带
LK1206 下列哪一种方法可以用来定位无线电噪音源或者恶意干扰源？<br>多普勒雷达<br>无线电测向<br>回波定位<br>相位锁定	无线电测向
LK1207 下列哪一项，是在竞赛中与其他电台通联时的良好习惯？<br>三项全部正确<br>尽可能不发送除了呼号和必要的信号报告以外的其他信息<br>如果频率上有电台堆叠，要确保每次只报自己呼号的后两位<br>为了确保自己在对方的日志中，要和他通联两次	尽可能不发送除了呼号和必要的信号报告以外的其他信息
LK1208 业余无线电通信所说的“网格定位”是什么意思？<br>用来调谐末级功放的设备<br>一个由一串字母和数字确定的地理位置<br>用于无线电测向运动的设备<br>一个由一串字母和数字确定的方位角和仰角	一个由一串字母和数字确定的地理位置
LK1209 什么是PSK31？<br>一种可以减少噪音对FM信号干扰的方法<br>一种压缩数字电视信号的方法<br>一种高速率的数据通信模式<br>一种低速率的数据通信模式	一种低速率的数据通信模式
LK1210 什么是八木天线？<br>一种可以集中聚集某一方向信号的天线<br>一种由日本八木秀次发明的全向天线<br>用八根木头制作的天线<br>一种可以将接收到的信号反向的天线	一种可以集中聚集某一方向信号的天线
LK1211 下列关于直立天线的陈述，哪一项是正确的？<br>该天线发射的电磁波磁场垂直于地面<br>相位被反相了<br>该天线发射的电磁波电场垂直于地面<br>相位被倒转了	该天线发射的电磁波电场垂直于地面
LK1212 下列哪一项描述了一个导线与地球表面平行架设的偶极子天线的性质？<br>是垂直极化的天线<br>是地波天线<br>是水平极化的天线<br>是菱形天线	是水平极化的天线
LK1213 就大多数手持电台随机附送的“橡皮天线”来说，它的劣势是什么？<br>以上三项全部正确<br>如果橡胶的一头损坏了，那么它很快就会解体<br>它发射的是圆极化的信号<br>相对于全尺寸天线，它的发射和接收效率较低	相对于全尺寸天线，它的发射和接收效率较低
LK1214 对一个偶极子天线怎么做，才能让它的谐振频率升高一些？<br>在振子某部位串联一个线圈<br>将振子加长一些<br>将振子截短一些<br>在振子的两端加上电容帽	将振子截短一些
LK1215 在自由空间中的半波偶极子天线，哪个方向的辐射强度最大？<br>沿着导体的方向<br>沿着馈线的方向<br>各个方向强度相同<br>垂直于导体的方向	垂直于导体的方向
LK1216 天线的增益是什么意思？<br>当发射机在更高的频率发射时，天线会额外地减少一部分功率<br>相对于参考天线，发射或接收时的阻抗增加<br>对于发射机的功率输入，天线附加的一部分额外功率<br>相对于参考天线，在某一方向上信号强度的增加	相对于参考天线，在某一方向上信号强度的增加
LK1217 为什么在使用同轴电缆连接天线时，最好有一个较低的驻波比？<br>减少对电视的干扰<br>能延长天线的使用寿命<br>使能量更有效率地传送，减少损耗<br>能延长发信机的使用寿命	使能量更有效率地传送，减少损耗
LK1218 业余无线电普遍使用的同轴电缆的特性阻抗是？<br>600欧姆<br>50欧姆<br>12欧姆<br>8欧姆	50欧姆
LK1219 为什么同轴电缆在业余无线电界的使用相对于其他馈线来说更多？<br>因为它比其它任何一种馈线都便宜<br>因为它使用方便，与周围环境之间的相互影响小<br>因为它可以相对其它馈线传送更大的功率<br>因为它比其它任何一种馈线的损耗都低	因为它使用方便，与周围环境之间的相互影响小
LK1220 收发信机天线调谐器（天调）的作用是什么？<br>它能够依照发射机当前工作的波段自动连接合适的天线<br>它可以使一部天线既能作为发射天线，又能作为接收天线<br>它帮助接收机在遇到弱信号时能自动调准频率<br>它将发射机的输出阻抗和天线的输入阻抗进行良好的匹配	它将发射机的输出阻抗和天线的输入阻抗进行良好的匹配
LK1221 通过同轴电缆的信号频率越高，通常产生什么影响？<br>反射功率越高<br>损耗越高<br>特性阻抗越高<br>驻波比越高	损耗越高
LK1222 对于400MHz以上的信号，通常会使用的同轴电缆连接器是：<br>RS-213型连接器<br>DB-23型连接器<br>M型连接器<br>N型连接器	N型连接器
LK1223 下列哪一项有可能导致驻波比不稳定读数的？<br>发射机过调制<br>来自其他电台的干扰导致信号失真<br>发射机采用了频率调制<br>天线与馈线的连接头接触不良	天线与馈线的连接头接触不良
LK1224 下列馈线中，哪一种在VHF和UHF频段的损耗最小？<br>多芯不平衡电缆<br>空气介质同轴硬电缆<br>50欧姆同轴软电缆<br>75欧姆同轴软电缆	空气介质同轴硬电缆
LK1225 电路中的保险丝起到什么作用？<br>防止电源纹波损害电路<br>限制电流，防止触电<br>以上三项全部正确<br>过载时切断电路	过载时切断电路
LK1226 为什么在需要安装5安培保险丝的地方安装一个20安培的保险丝是不可取的？<br>因为20安培的保险丝电流更大，所以它更容易熔断<br>其他三项全部正确<br>电源的纹波会显著增大<br>过大的电流可能导致火灾	过大的电流可能导致火灾
LK1227 防止设备外壳带电危险的措施包括：<br>所有使用交流供电的设备的电源线都使用带有单独保护地线端的三线插头<br>将所有的交流供电设备全部连接至一个安全地线<br>其他三项全部正确<br>安装漏电保护断路器	其他三项全部正确
LK1228 在为同轴电缆馈线安装避雷器时应当注意什么？<br>将所有避雷器的地线接到同一个金属板上，然后将这个金属板接到室外的接地极<br>要在每一个避雷器处两端并联一个开关，以便在使用大功率输出的时候可以将避雷器旁路掉<br>在每一个避雷器的接地线上安装开关，以防止射频过载损伤避雷器<br>将每一个避雷器单独引出接地线，并且将它们都连接至电台的地线	将所有避雷器的地线接到同一个金属板上，然后将这个金属板接到室外的接地极
LK1229 如何在电网停电的状况下给一个12伏的铅酸蓄电池充电？<br>将蓄电池放在冰里冷却一会儿<br>将蓄电池串联一个电灯泡作为限流装置，然后连接到220伏市电上<br>给蓄电池中加一些酸<br>将蓄电池连接与汽车的蓄电池并联，并且发动汽车	将蓄电池连接与汽车的蓄电池并联，并且发动汽车
LK1230 常规的12伏酸铅蓄电池通常有什么潜在的危险？<br>它会释放臭氧，进而污染大气层<br>长时间不使用可能会引起自燃<br>如果通风不良，有爆炸风险的气体会聚集<br>有高电压，存在触电的风险	如果通风不良，有爆炸风险的气体会聚集
LK1231 如果铅酸蓄电池的充电和放电进行得过快会怎样？<br>可能会产生过高的充电电压，引起触电的危险<br>电压会将为负值<br>电池可能会过热，甚至释放出可燃气体，甚至可能爆炸<br>“记忆效应”将使电池的可用容量减小	电池可能会过热，甚至释放出可燃气体，甚至可能爆炸
LK1232 以下哪一项是天线铁塔安装防雷接地的良好措施？<br>确保接地线的所有需要弯折的地方都是干净的直角弯<br>接地连接要尽可能地短而直接<br>为接地系统做好防水处理<br>打入地面的接地极要尽量远离天线塔	接地连接要尽可能地短而直接
LK1233 设备电源拔掉电源线以后，检修时还有什么安全风险？<br>充满高电压的电容器可能造成电击<br>静电可能损坏接地系统<br>打开电源外壳可能引起保险丝烧断<br>地磁场可能在变压器中激起感应电流导致电源损坏	充满高电压的电容器可能造成电击
LK1234 自制一台由220伏交流供电的设备，推荐采用的安全措施是：<br>交流电源入口火线端串联安装保险丝<br>在交流供电入口处并联安装一个交流电压表<br>在交流供电入口处并联安装一个电容<br>在交流供电入口处串联安装一个电感	交流电源入口火线端串联安装保险丝
LK1235 VHF和UHF信号属于下面哪一类辐射？<br>非电离辐射<br>阿尔法辐射<br>电离辐射<br>伽玛辐射	非电离辐射
LK1236 为什么电磁辐射防护规定国家标准中的照射限值随着频率的变化而不同？<br>在自然中高频电磁波不常见<br>人体会对某些特定频率的电磁波吸收量更大<br>较低频率的无线电波不会穿透人体<br>较低频率的无线电波相对高频率的无线电波拥有更高的能量	人体会对某些特定频率的电磁波吸收量更大
LK1237 一些VHF/UHF业余无线电调频手持对讲机或车载台的设置菜单中有“全频偏”和“半频偏”的选择，其表示的意义是：<br>全频偏方式语音信号经过压缩，半频偏方式语音信号只压缩低音频分量<br>全频偏方式适用于收发异频的中继台通信，半频偏方式适用于同频对讲通信<br>分别表示信道间隔为25kHz或者12.5kHz<br>全频偏方式下发射频率的误差比半频偏方式大一倍	分别表示信道间隔为25kHz或者12.5kHz